border_size=1
usage=map

Hh          , Hh          , Mm          , Mm          , Mm          , Hh          , Gs          , Gg          , Gs          , Gg          , Ww          , Gg          , Ww          , Gg          , Gs^Fp       , Rr          , Gg          , Gg          , Gs^Fp       , Gs^Fp       , Gg          , Gg          , Ss          , Ss          , Ss          , Gs^Fp       , Gs^Fdw      , Gs^Fp       , Gs^Fp       , Gs^Fp       , Gs^Fp       , Gs^Fp       
Hh          , Hh          , Mm          , Mm          , Mm^Vhh      , Hh          , Gs          , Gs          , Gg          , Gg          , Ww          , Gg          , Ww          , Gg          , Gs^Fmw      , Rr          , Gg          , Gg          , Gs^Fdw      , Gs^Fmw      , Gg          , Gg          , Ss          , Ss          , Ss          , Gs^Fdw      , Gs^Fmw      , Gs^Fp       , Gs^Fp       , Gs^Fp       , Gs^Fp       , Gs^Fp       
Mm          , Mm          , Hh          , Mm          , Hh          , Hh          , Gs          , Gg          , Gg          , Gs          , Gg          , Gg          , Ww          , Ww          , Gg          , Rr          , Gs^Fp       , Gg          , Gs^Fdw      , Gs^Fmw      , Gg          , Gs          , Gs^Fp       , Gs^Fp       , Gs^Fp       , Gs          , Gs^Fp       , Gs^Fp       , Gg^Vh       , Gs^Fp       , Gs^Fp       , Gs^Fp       
Mm          , Mm          , Hh          , Hh          , Gg          , Hh          , Hh          , Gg          , Gs          , Gg          , Hh          , Hh          , Gg          , Gg          , Gg          , Rr          , Rr          , Gs          , Gs          , Gs^Fp       , Gg          , Gs          , Gg          , Gs          , Gg          , Gs          , Gs^Fmw      , Gg          , Gg          , Gs^Fp       , Gs^Fp       , Gs^Fp       
Mm          , Mm          , Mm          , Hh          , Hh          , Mm          , Gg          , Hh          , Gs          , Gs^Fmw      , Gs          , Gs          , Gg          , Hh          , Hh          , Gg          , Gg          , Rr          , Gg          , Gg          , Gg          , Gg          , Ce          , Gg          , Gg          , Gg          , Gs^Fp       , Gs^Fp       , Gg          , Ss          , Ss          , Ss          
Mm          , Mm          , Hh          , Hh          , Hh          , Hh          , Hh          , Gg          , Gs^Fdw      , Hh          , Gs          , Gs          , Gg^Vh       , Gg          , Gs^Fmw      , Gs^Fdw      , Gg          , Rr          , Rr          , Rr          , Rr          , Ce          , Gg^Vh       , Ce          , Gg          , Gg          , Gg          , Gs^Fp       , Gg          , Ss          , Gs^Fmw      , Gs^Fp       
Mm          , Mm          , Mm          , Mm          , Hh          , Mm          , Gg          , Hh          , Gg          , Hh          , Gg          , Gg          , Ss          , Ss          , Ww          , Gg          , Gs^Fp       , Gs          , Gg          , Gg          , Ce          , Rr          , Rr          , Rr          , Gg^Vh       , Ce          , Gg          , Gg          , Gs^Fdw      , Gs^Fdw      , Gs^Fmw      , Gs^Fp       
Mm          , Mm          , Mm          , Mm          , Hh          , Hh          , Gg          , Gs          , Gs          , Hh          , Gg          , Gg          , Ww          , Ww          , Hh          , Ww          , Gg          , Gs          , Gs          , Gg          , Ce          , Gg^Vh       , Gg^Vh       , Rr          , Rr          , Ce          , Gg          , Gs^Fmw      , Gg          , Gs^Fdw      , Gs^Fmw      , Gs^Fp       
Mm          , Mm          , Mm^Vhh      , Mm          , Hh          , Hh          , Hh          , Gs          , Gg          , Hh          , Hh          , Hh          , Gs^Fp       , Gg          , Gg          , Gg          , Ww          , Gs^Fp       , Gg          , Gg          , Gg          , Ce          , 1 Ke        , Ce          , Gg          , Rr          , Gg          , Gg          , Gs^Fp       , Gs^Fp       , Gs          , Gg          
Mm          , Mm          , Mm          , Mm          , Hh          , Mm          , Hh          , Gg          , Hh          , Gg          , Gg          , Gg          , Hh          , Gs^Fp       , Hh          , Gg          , Ss          , Ss          , Gg          , Gs          , Gg          , Gg          , Gg          , Gg          , Gg          , Rr          , Rr          , Gs          , Gg          , Gs          , Gs^Fp       , Gs^Fp       
Mm          , Mm          , Hh          , Mm          , Mm          , Mm          , Hh          , Hh          , Mm          , Hh          , Hh          , Hh          , Gg          , Hh          , Gs          , Gs          , Gg          , Ss          , Ss          , Ww          , Gs^Fp       , Ww          , Ww          , Ww          , Gg          , Gs^Fp       , Rr          , Gg          , Gg          , Gg^Vh       , Gs^Fmw      , Gs^Fp       
Hh          , Hh          , Hh          , Mm          , Mm          , Hh          , Mm          , Hh          , Hh          , Hh          , Gs          , Gs          , Hh^Vhh      , Gg          , Gg          , Gs          , Hh          , Gg          , Gg          , Ww          , Gs^Fp       , Gg          , Gg          , Gs^Fmw      , Gs^Fdw      , Gs^Fmw      , Gg          , Rr          , Gg          , Gg          , Gg          , Gg          
Mm          , Mm          , Mm          , Mm          , Mm          , Mm          , Mm          , Hh          , Hh          , Gg          , Hh          , Hh          , Hh          , Hh          , Hh          , Gs          , Gg          , Hh          , Gg          , Ss          , Ss          , Ss          , Gg          , Gg          , Gs^Fp       , Gs^Fdw      , Rd          , Rr          , Rr          , Rr          , Rr          , Rr          
Mm          , Mm          , Mm          , Hh          , Chr         , Mm          , Mm          , Hh          , Hh          , Hh          , Hh          , Mm          , Hh          , Hh          , Ss          , Gg          , Ww          , Gg          , Ss          , Ww          , Ww          , Gg          , Ss          , Gg          , Gg          , Gg          , Gg          , Gs^Fp       , Gg          , Gs          , Gs          , Gg          
Mm          , Mm          , Hh          , Chr         , 2 Kh        , Chr         , Hh          , Mm          , Mm          , Hh          , Hh          , Hh          , Ss          , Ss          , Hh          , Gg          , Ww          , Ss          , Gg          , Gg^Vh       , Ss          , Ss          , Ww          , Gg          , Rd          , Rd          , Gg          , Gg          , Ss          , Gs          , Gg          , Gg          
Mm          , Mm          , Mm          , Chr         , Hh          , Chr         , Mm          , Mm          , Mm^Vhh      , Mm          , Hh          , Hh          , Gs          , Ss          , Gg          , Ww          , Ww          , Gg          , Gg          , Gg          , Ww          , Ww          , Ww          , Rd          , Ww          , Gg          , Gg          , Ss          , Gg          , Gs^Fdw      , Gg          , Gg          
Mm          , Mm          , Hh          , Mm          , Mm          , Mm          , Mm          , Mm          , Hh          , Mm          , Gs          , Gs          , Gs          , Gs^Fdw      , Gg          , Gg          , Hh          , Hh          , Gg          , Hh          , Ss          , Hh          , Gg          , Ww^Bw|      , Gs^Fp       , Ss          , Gg          , Gs^Fp       , Gg          , Gs^Fp       , Gs          , Gs          
Mm          , Mm          , Hh          , Mm          , Mm          , Mm          , Mm          , Mm          , Hh          , Hh          , Gg          , Gg          , Hh          , Hh          , Hh          , Gs          , Gg          , Gg          , Ss          , Ss          , Hh          , Gs          , Gs^Fp       , Rd          , Gs^Fdw      , Gs          , Ww          , Gg          , Ww          , Gs^Fp       , Gg          , Gs          
Mm          , Mm          , Mm          , Mm          , Mm          , Mm          , Mm          , Mm          , Hh          , Hh          , Hh          , Hh          , Mm          , Hh          , Hh          , Hh          , Gs          , Gs          , Ss          , Hh          , Hh          , Gg          , Rd          , Rd          , Gg          , Gg          , Ww          , Gg          , Ss          , Gg          , Gg          , Gg          
Mm          , Mm          , Mm          , Mm          , Mm          , Mm          , Mm          , Mm          , Mm          , Hh          , Hh          , Mm          , Hh          , Hh^Vhh      , Hh          , Gg          , Gg          , Gs          , Hh          , Hh          , Ss          , Rd          , Gg          , Gg          , Ss          , Ww          , Gs          , Ss          , Gg          , Ss          , Gg          , Gg          
Mm          , Mm          , Mm          , Mm          , Mm          , Mm          , Hh          , Mm          , Mm          , Mm          , Hh          , Hh          , Hh          , Hh          , Hh          , Hh          , Gg          , Gg          , Rd          , Rd          , Gg          , Ss          , Hh          , Gs          , Gs          , Gg          , Gs          , Ss          , Ss          , Ss          , Gs          , Gg          
Mm          , Mm          , Mm^Vhh      , Mm          , Mm          , Mm          , Mm          , Hh          , Mm          , Mm          , Mm          , Hh          , Mm          , Hh          , Hh          , Hh          , Gs          , Hh          , Rd          , Gg          , Ss          , Gg          , Ss          , Gs          , Hh          , Hh          , Hh          , Gg          , Gs^Fdw      , Gg          , Gs          , Gs          
Mm          , Mm          , Mm          , Mm          , Mm          , Mm          , Mm          , Mm          , Mm          , Mm          , Mm          , Mm          , Hh          , Mm          , Hh          , Gs          , Gs          , Gs          , Ss          , Gg          , Ss          , Ss          , Gg          , Gg          , Gg          , Gg          , Ss          , Gg          , Ww          , Ss          , Ss          , Ss          
Mm          , Mm          , Mm          , Mm          , Mm          , Mm          , Mm          , Hh          , Hh          , Hh          , Hh          , Hh          , Gs          , Hh          , Gg          , Gg          , Rd          , Rd          , Hh          , Ss          , Ss          , Gg          , Ww          , Ww          , Gg          , Gg          , Gg          , Ss          , Ww          , Ss          , Gg          , Gg          
Mm          , Mm          , Mm          , Mm          , Mm          , Mm          , Mm          , Hh          , Hh          , Hh          , Hh          , Hh          , Gg          , Hh          , Hh          , Hh          , Rd          , Gg          , Hh          , Hh          , Ww          , Gg          , Hh          , Gg          , Hh          , Gg          , Ss          , Gg          , Hh          , Hh          , Gg          , Gg          
Mm          , Mm          , Mm          , Mm          , Mm          , Mm          , Hh          , Mm          , Rd          , Rd          , Hh          , Rd          , Rd          , Gg          , Ss          , Rd          , Hh          , Gg          , Gg          , Gg          , Ww          , Ww          , Gg          , Gg          , Hh          , Ss          , Ss          , Ss          , Ss          , Hh          , Gg          , Gg          
Mm          , Mm          , Mm          , Mm          , Mm          , Mm          , Mm^Vhh      , Mm          , Mm          , Hh          , Hh          , Gg          , Gs          , Rd          , Ss          , Hh          , Mm          , Mm          , Mm          , Hh          , Gg          , Ww          , Gs^Fdw      , Gs^Fmw      , Gs^Fp       , Gg          , Ss          , Ss          , Ss          , Gg          , Gs          , Gs          
Mm          , Mm          , Mm          , Mm          , Mm          , Mm          , Mm          , Mm          , Mm          , Mm          , Mm          , Hh          , Hh          , Gg          , Ss          , Ss          , Hh          , Mm          , Hh          , Gg          , Hh          , Gg          , Gs^Fp       , Gs^Fmw      , Gs          , Gg          , Gg          , Gg          , Gg          , Ss          , Gg          , Gs          
Mm          , Mm          , Mm          , Mm          , Mm          , Mm          , Mm          , Mm          , Mm          , Mm          , Mm          , Hh          , Hh          , Hh          , Hh          , Gg          , Gs          , Hh          , Gg          , Hh          , Hh          , Hh          , Gg          , Gs          , Gs          , Gs          , Ww          , Gg          , Gg          , Ss          , Gg          , Gg          
Mm          , Mm          , Mm          , Mm          , Mm          , Mm          , Mm          , Mm          , Mm          , Mm          , Mm          , Mm          , Mm          , Mm          , Hh          , Hh          , Hh          , Gs          , Gg          , Hh          , Hh          , Hh^Vhh      , Gg          , Gs          , Ww          , Gg          , Ww          , Gg          , Gs          , Gg          , Gg          , Gg          
Mm          , Mm          , Mm          , Mm          , Mm          , Mm          , Mm          , Mm          , Mm          , Mm          , Mm          , Mm          , Mm          , Mm          , Hh          , Hh          , Hh          , Gg          , Gg          , Hh          , Hh          , Hh          , Gg          , Gg          , Ww          , Gg          , Ww          , Gg          , Gs          , Gs          , Gg          , Gg          
