border_size=1
usage=map

Gg          , Gg          , Gg          , Gs^Fmf      , Gs^Fdf      , Gs^Fp       , Gg          , Gs^Fp       , Gg          , Gs^Fp       , Gg          , Gs^Fp       , Gs          , Gg          , Mm          , Gg          , Gg          , Gg          , Gg          , Gg          , Ww          , Ww          , Ww          , Ww          , Gg          , Gg          , Gg          , Gg          , Gs^Fmf      , Gs^Fp       , Gs^Fmf      , Gg          , Gs^Fmf      , Gg          , Gs^Fp       , Gg          , Gg          , Gg          
Gg          , Gg          , Gg          , Gs^Fmf      , Gs^Fmf      , Gs^Fmf      , Gg          , Gs^Fp       , Gs          , Gs^Fp       , Gg          , Gs^Fp       , Gs          , Gs          , Mm          , Gg          , Gg^Gvs      , Gg^Gvs      , Gg^Gvs      , Gg^Gvs      , Ww          , Ww          , Ww          , Ww          , Gg          , Gg          , Gg          , Gg          , Gs^Fp       , Gs^Fp       , Gs^Fdf      , Gs          , Gs^Fmf      , Gs          , Gs^Fp       , Gs          , Gg          , Gg          
Gg          , Gg          , Gs^Fp       , Gg          , Gs^Fp       , Hh          , Mm          , Hh          , Hh          , Gs^Fp       , Gs^Fmf      , Gs^Fp       , Hh          , Hh          , Mm          , Gg          , Gg^Gvs      , Gg^Gvs      , Gg^Gvs      , Gg^Gvs      , Ww          , Ww          , Ww          , Ww          , Ww          , Gg          , Gg          , Gs^Fp       , Gs^Fmf      , Gs^Fmf      , Gs^Fdf      , Gs^Fmf      , Gs          , Gg          , Gg          , Gg          , Gg          , Gg          
Gg          , Gg          , Gs^Fdf      , Gs^Fmf      , Gs^Fp       , Hh          , Hh          , Gg^Vh       , Gs^Fp       , Gs^Fp       , Gs^Fdf      , Gs^Fp       , Gs          , Hh          , Gs^Fmf      , Hh          , Gg^Gvs      , Gg^Gvs      , Gg^Gvs      , Ww          , Gg^Gvs      , Ww          , Ww          , Ww          , Ww          , Ww          , Gg          , Gg          , Gg          , Gs^Fp       , Gs^Fmf      , Gs          , Gg          , Gg          , Gg^Ve       , Gg          , Gg          , Gg          
Gg          , Gg          , Gg          , Gs          , Gg          , Gs          , Gs^Fp       , Gs^Fp       , Gs^Fmf      , Gs^Fmf      , Gs^Fdf      , Gs^Fmf      , Gs^Fmf      , Gs^Fdf      , Gs^Fdf      , Gg          , Gg^Gvs      , Gg^Gvs      , Gg^Vh       , Gg^Gvs      , Gg^Gvs      , Gg^Gvs      , Ww          , Ww          , Ww          , Ww          , Gg          , Gg          , Gg          , Gg          , Gg          , Gg          , Gs          , Gs^Fp       , Gg          , Gg          , Gg          , Gg          
Gg          , Gg          , Gg          , Gs^Fp       , Gg          , Gs^Fp       , Gs          , Gs^Fp       , Gs^Fp       , Gs^Fmf      , Gg          , Gs^Fp       , Gs^Fmf      , Gs^Fmf      , Gg^Gvs      , Gg^Gvs      , Gg^Gvs      , Gg^Gvs      , Gg^Gvs      , Gg^Gvs      , Gg^Gvs      , Gg^Gvs      , Gg^Gvs      , Ww          , Ww          , Gg          , Ww          , Gg          , Gg          , Gg          , Gs^Fmf      , Gg          , Gs^Fdf      , Gs^Fmf      , Gg          , Gg          , Gg          , Gg          
Gg          , Gg          , Gg          , Gs          , Gs^Fmf      , Gs^Fp       , Hh          , Mm          , Mm          , Hh          , Hh          , Gs^Fp       , Gg          , Gs^Fp       , Gg^Gvs      , Gg^Gvs      , Gg^Gvs      , Gg^Gvs      , Gg^Gvs      , Gg^Gvs      , Gg^Gvs      , Gg^Gvs      , Gg^Vh       , Ww          , Ww          , Ww          , Ww          , Gg          , Gg          , Gg          , Gs^Fdf      , Gs^Fmf      , Gg          , Gg          , Gg          , Gg          , Gg          , Gg          
Gg          , Gg          , Gg          , Gs^Fmf      , Gg          , Gg          , Hh          , Mm          , Gg          , Gg          , Gs^Fmf      , Gg          , Gg^Gvs      , Gg^Gvs      , Ww          , Gg^Gvs      , Ww          , Gg^Gvs      , Ww          , Gg^Gvs      , Ww          , Gg^Gvs      , Ww          , Ww          , Ww          , Ww          , Gs^Fp       , Gg          , Gg          , Gg          , Hh          , Gg          , Hh          , Gg          , Gg          , Gg^Ve       , Gg          , Gg          
Gg          , Gg          , Gs^Fmf      , Gs^Fdf      , Hh          , Gg          , Gs^Fmf      , Gs^Fmf      , Gs^Fp       , Gs^Fdf      , Gg          , Gg          , Gg          , Gg          , Ww          , Gg          , Ww          , Ww          , Ww          , Ww          , Ww          , Ww          , Ww          , Ww          , Ww          , Gg          , Gg          , Gg          , Hh          , Hh          , Mm          , Hh          , Gg          , Gg          , Gg          , Gg          , Gg          , Gg          
Gg          , Gg          , Gg          , Gg          , Hh          , Mm          , Gs^Fp       , Gs^Fdf      , Gg          , Gs^Fp       , Gg          , Gg          , Gg          , Gg          , Ww          , Ww          , Ww          , Ww          , Ww          , Ww          , Ww          , Ww          , Ds          , Ww          , Gg          , Gg          , Gg          , Gg          , Hh          , Hh          , Hh          , Hh          , Gg          , Gg          , Ce          , Gg          , Gg          , Gg          
Gs^Fp       , Gs^Fp       , Gg^Vh       , Hh          , Hh          , Mm          , Gg          , Gs^Fp       , Gg          , Gg          , Ww          , Gg          , Ww          , Gg          , Ww          , Ww          , Ww          , Ww          , Ds          , Ds          , Gg          , Ds          , Ds          , Gg          , Gg          , Ds          , Gg          , Gg          , Gg          , Gg          , Gg          , Gg          , Ce          , Ce          , 4 Ke        , Ce          , Rp          , Rp          
Gg          , Gg          , Gs^Fmf      , Gg          , Hh          , Hh          , Hh          , Gs^Fp       , Gs          , Ww          , Ww          , Ww          , Ww          , Ww          , Ww          , Ww          , Ww          , Ds          , Ds          , Ds          , Gg          , Gg          , Ds          , Gg          , Gs^Fmf      , Gg          , Gg          , Gg^Ve       , Gg          , Gg          , Rp          , Rp          , Rp          , Ce          , Rp          , Rp          , Gg          , Gg          
Gg          , Gg          , Gg          , Gs^Fmf      , Gg          , Gs^Fp       , Gs          , Gs          , Ch          , Ch          , Rp          , Ww          , Ww          , Ww          , Ww          , Ww          , Ww          , Ds          , Ds          , Ds          , Gg          , Gg          , Gg          , Gg          , Gg          , Gs^Fdf      , Gg          , Gg          , Rp          , Rp          , Gg          , Gg          , Gg          , Rp          , Gg          , Gg          , Gg^Ve       , Gg          
Gg          , Gg          , Gs^Fp       , Gg          , Gs          , Gs          , Ch          , Ds          , Rp          , Rp^Vhc      , Ww          , Rp^Vhc      , Ww          , Ww          , Ch          , Ww          , Ds          , Gg          , Gg          , Ds          , Gg          , Ds          , Gg          , Gg          , Rp          , Rp          , Rp          , Rp          , Gg          , Gg          , Gg          , Gg          , Gg          , Gg          , Gg          , Gg          , Gg          , Gg          
Gg          , Gg          , Gg          , Gs^Fp       , Gs          , Ch          , Kh          , Rp          , Rp^Vhc      , Ww          , Ww          , Ww          , Ww          , Ww          , Ww          , Ww          , Rp          , Rp          , Rp          , Gg          , Ds          , Gg          , Rp          , Rp          , Gg          , Gg          , Gg          , Gs^Fmf      , Gg          , Gs^Fmf      , Gg          , Gg          , Gg          , Gg^Ve       , Gg          , Gg          , Gg          , Gg          
Gg          , Gg          , Gg          , Gg          , Gs          , Ch          , Rp          , Rp          , Ww          , Ww          , Rp          , Rp          , Ww          , Rp^Vhc      , Rp          , Rp          , Gs          , Gs^Fdf      , Gg          , Rp          , Rp          , Rp          , Gs^Fp       , Gg          , Gg          , Gg^Ve       , Gg          , Gg          , Gg          , Gg          , Gg          , Gs^Fmf      , Gs^Fdf      , Gg          , Gs^Fmf      , Gg          , Gg          , Gg          
Gs^Fp       , Gs^Fp       , Gs^Fmf      , Gs^Fmf      , Gs          , Ch          , Rp          , Rp^Vhc      , Ww          , Ww          , Ww          , Rp^Vhc      , Ww          , Rp          , Rp          , Ch          , Gs          , Gg          , Gg          , Gg          , Gg          , Gg          , Gg          , Gg          , Gs^Fp       , Gs^Fp       , Gg          , Gg          , Gs^Fp       , Gg          , Gs          , Gs          , Gg          , Hh          , Hh          , Gg          , Hh          , Hh          
Gg          , Gg          , Gs^Fmf      , Gs^Fdf      , Gs          , Rp          , 3 Ch        , Rp          , Ww          , Ww          , Ds          , Ww          , Rp^Vhc      , Rp          , Kh          , Ch          , Gs          , Gs^Fmf      , Gg          , Gg          , Gs^Fmf      , Gs^Fmf      , Gs^Fmf      , Gs^Fp       , Gs          , Gs^Fp       , Gs^Fmf      , Gs^Fdf      , Gs^Fmf      , Gs^Fmf      , Gs^Fp       , Gs^Fp       , Gg          , Hh          , Mm          , Mm          , Gs          , Gg          
Gs^Fp       , Gs^Fdf      , Gs^Fdf      , Gs^Fp       , Gs^Fp       , Rp          , Gs          , 2 Ch        , Ww          , Ww          , Ds          , Rp          , Rp          , Rp          , Ch          , Ch          , Gs          , Gg          , Gs^Fmf      , Gs^Fdf      , Gs^Fmf      , Gs^Fdf      , Gs          , Gs          , Gg          , Gg          , Gg          , Gs^Fdf      , Gs^Fmf      , Gg          , Gg          , Gs^Fp       , Gg          , Hh          , Gs          , Hh          , Gs          , Gs          
Gs^Fp       , Gs^Fmf      , Rp          , Rp          , 1 Rp        , Rp          , Gg          , Ww          , Ds          , Ww          , Ww          , Rp^Vhc      , Ww          , Ch          , Gs          , Gs          , Gs          , Gs^Fp       , Gg          , Gg          , Gs          , Gs^Fmf      , Gs          , Gg          , Gg^Ve       , Gs          , Gs^Fdf      , Gs^Fmf      , Gs          , Hh          , Gs^Fp       , Gs^Fp       , Gs^Fp       , Gs          , Gs^Fp       , Hh          , Gg          , Gg          
Rp          , Rp          , Gs^Fp       , Gs^Fp       , Gs^Fp       , Gg          , Gg          , Ww          , Ss^Vhs      , Ww          , Ww          , Ww          , Ww          , Ww          , Gg          , Gs^Fp       , Gs^Fdf      , Gs^Fmf      , Gs          , Gs^Fp       , Gs^Fmf      , Gs          , Gs          , Gs^Fmf      , Gs          , Gs^Fmf      , Gs^Fmf      , Gs          , Gg          , Hh          , Mm          , Hh          , Gs^Fp       , Gs^Fp       , Gs          , Gg          , Gg          , Gg          
Gg          , Gg          , Gs^Fmf      , Gg          , Gs^Fmf      , Gg          , Gg          , Ww          , Gg          , Ww          , Ww          , Ww          , Ss^Vhs      , Ww          , Ww          , Gg          , Gg          , Gg          , Gg          , Gs          , Gs^Fdf      , Gg          , Gg          , Gg          , Gs          , Gg          , Gs^Fmf      , Gg          , Gs          , Hh          , Hh          , Gs          , Gs^Fp       , Gg          , Gs^Fp       , Gg^Ve       , Gg          , Gg          
Gg          , Gg          , Gs^Fdf      , Gs^Fmf      , Gs          , Gs^Fdf      , Gs^Fmf      , Ww          , Gg          , Ww          , Ww          , Ww          , Ss          , Ww          , Ww          , Gg          , Gg          , Gg          , Gs^Fp       , Gs^Fmf      , Gg          , Gs^Fdf      , Gs^Fmf      , Gg          , Gs^Fmf      , Gg          , Gs^Fdf      , Gs^Fmf      , Gs          , Gg          , Gg          , Gs          , Gs          , Gs^Fp       , Gg          , Gs^Fp       , Gg          , Gg          
Gg          , Gg          , Gs^Fmf      , Gs^Fp       , Gs          , Gs^Fmf      , Gg          , Ww          , Ww          , Ww          , Ww          , Gg          , Ss          , Gg          , Ww          , Gg          , Gg          , Gg          , Gs          , Gs^Fmf      , Gs^Fp       , Gg          , Gs^Fp       , Gs^Fmf      , Gg          , Gs^Fp       , Gs^Fmf      , Gs^Fmf      , Gs^Fp       , Gg          , Gg          , Gg          , Gg          , Gg          , Gg          , Gg          , Gg          , Gg          
Gg          , Gg          , Gs^Fp       , Gs^Fp       , Gs^Fp       , Gs^Fp       , Gg          , Gg          , Gg          , Ww          , Ww          , Gg          , Gg          , Gg          , Ww          , Ww          , Ww          , Gg          , Gg          , Gg          , Gg          , Gs^Fmf      , Gs          , Gs^Fp       , Hh          , Hh          , Hh          , Gg          , Gs^Fdf      , Gs^Fmf      , Gs          , Gs^Fmf      , Gg          , Gg          , Gg^Ve       , Gg          , Gg          , Gg          
Gg          , Gg          , Gs^Fmf      , Gs          , Hh          , Gs^Fp       , Gs          , Gg          , Gg          , Ww          , Ww          , Ww          , Ww          , Ww          , Ss          , Gg          , Gg          , Ww          , Gg          , Gg          , Gg          , Gs          , Gs          , Gg          , Gg          , Hh          , Hh          , Gs^Fmf      , Gs^Fmf      , Gs^Fp       , Gs          , Gg          , Gg          , Gs^Fmf      , Gg          , Gs^Fp       , Gg          , Gg          
Gs^Fp       , Gs^Fmf      , Ss^Vhs      , Hh          , Hh          , Gs^Fp       , Gs          , Gg          , Ss^Vhs      , Ww          , Ww          , Ww          , Ww          , Ww          , Ss          , Ww          , Ww          , Ww          , Ww          , Ss          , Ww          , Gg          , Gs          , Gs          , Gg          , Hh          , Gg          , Hh          , Gs          , Gs^Fmf      , Gs^Fp       , Gs          , Gg          , Gs^Fmf      , Gs          , Gs^Fmf      , Gs^Fp       , Gs^Fp       
Gs^Fp       , Gs^Fdf      , Gs^Fp       , Hh          , Hh          , Gs^Fdf      , Gs^Fp       , Gg          , Ww          , Gg          , Ww          , Gs^Fp       , Gs          , Ww          , Ww          , Ss          , Ww          , Ww          , Ww          , Ss^Vhs      , Ww          , Ww          , Ww          , Gg          , Ww          , Gg          , Ww          , Gg          , Gs          , Gs          , Gs^Fmf      , Gg          , Gs^Fp       , Gs^Fp       , Gg          , Gs^Fdf      , Gs^Fmf      , Gs^Fp       
Gg          , Gs          , Gs^Fmf      , Gs^Fdf      , Gs^Fmf      , Gs^Fp       , Gs          , Gg          , Ww          , Gg          , Ww          , Gg          , Ss          , Ss          , Gs^Fmf      , Ww          , Gg          , Gs          , Gg          , Ww          , Ww          , Ww          , Ww          , Ww          , Ww          , Ww          , Gg          , Ww          , Hh          , Hh          , Hh          , Hh          , Hh          , Gs          , Gg^Ve       , Gs^Fmf      , Gg          , Gg          
Gs^Fp       , Gs^Fp       , Gs^Fp       , Gs          , Gs^Fmf      , Gs          , Gg          , Gg          , Ww          , Ww          , Gg          , Ss          , Gs          , Gs^Fp       , Ww          , Ww          , Ww          , Ss          , Ss          , Ss          , Ww          , Ww          , Ww          , Ww          , Ss          , Ww          , Ss          , Gg          , Hh          , Hh          , Hh          , Gg          , Gg          , Gg          , Gs^Fmf      , Gs^Fp       , Gs          , Gs          
Gg          , Gg          , Gs^Fp       , Gg          , Gs^Fp       , Gs          , Gs          , Ww          , Gs          , Ww          , Ss^Vhs      , Ww          , Ww          , Gs          , Ww          , Ww          , Ss          , Gg          , Gs          , Gg          , Gg          , Ww          , Ss          , Ww          , Ww          , Ss          , Ss^Vhs      , Ss          , Hh          , Hh          , Gg          , Gs^Fp       , Gs^Fp       , Gs^Fdf      , Gs^Fdf      , Gs^Fmf      , Gs          , Gg          
Ce          , Ce          , Ke          , Ce          , Gs^Fp       , Gs^Fp       , Gg          , Ww          , Gs          , Gs^Fp       , Gg          , Gs          , Ww          , Gg          , Ww          , Gg          , Ss          , Gg          , Ww          , Gs          , Ww          , Gs          , Ss          , Gg          , Gg          , Ww          , Gg          , Ss          , Ww          , Gg          , Gs          , Gs          , Gg          , Gs^Fdf      , Gs^Fmf      , Gs^Fmf      , Gs          , Gg          
Ce          , Ce          , Gs          , Ce          , Hh          , Gg          , Hh          , Ww          , Gg          , Gs^Fp       , Ww          , Gg          , Ww          , Ww          , Gg          , Ss          , Gg          , Ss          , Ss          , Ww          , Ss          , Ww          , Ww          , Ww          , Ww          , Ww          , Ww          , Gg          , Ww          , Ss          , Ss          , Gs          , Ss          , Gs^Fmf      , Gs^Fp       , Gs          , Gg          , Gg          
Gg          , Gs          , Gs^Fp       , Gs^Fp       , Hh          , Hh          , Hh          , Hh          , Ww          , Gg          , Ss          , Ww          , Ww          , Gg          , Ww          , Gg          , Gg          , Ss^Vhs      , Gg          , Gs          , Gg          , Ww          , Gg          , Gs          , Gs          , Gg          , Gs          , Ss          , Ww          , Gg          , Ww          , Ss          , Gg          , Gg          , Gg          , Gs          , Gs^Fdf      , Gs^Fdf      
Gs^Fp       , Gs^Fdf      , Gs^Fmf      , Gs          , Gs          , Hh          , Hh          , Hh          , Gg          , Ww          , Ww          , Ss          , Ww          , Gg          , Gg          , Ww          , Ww          , Ww          , Ww          , Ww          , Ss          , Ww          , Ww          , Ww          , Ww          , Ww          , Ww          , Ww          , Ss          , Gg          , Gg          , Ww          , Gs^Fp       , Gg          , Gs^Fmf      , Gs^Fmf      , Gs          , Gg          
Gs^Fp       , Gs^Fmf      , Gs^Fp       , Gs          , Gs^Fmf      , Gs^Fmf      , Gs^Fmf      , Gs          , Gg          , Hh          , Hh          , Gg          , Hh          , Hh          , Gg          , Ww          , Gs          , Gg          , Ww          , Gs          , Gg          , Ss          , Ww          , Gg          , Gs          , Gs          , Gs          , Gg          , Ss          , Ss          , Gg          , Gg          , Gs          , Gs          , Gg          , Gs^Fdf      , Gs^Fmf      , Gs^Fp       
Gs^Fp       , Gs^Fp       , Gs^Fp       , Gg          , Gs^Fp       , Gs^Fdf      , Gs^Fp       , Gs          , Gg          , Hh          , Hh          , Gg          , Hh          , Hh          , Gg          , Ww          , Gg          , Gg          , Ww          , Gs          , Gg          , Ss          , Ww          , Gg          , Gg          , Gg          , Gg          , Gg          , Ss          , Ss          , Gg          , Gs          , Gg          , Gs          , Gg          , Gs^Fp       , Gs^Fp       , Gs^Fp       
