border_size=1
usage=map

Gg          , Gg          , Gg          , Gg          , Gg          , Ww          , Ww          , Wwf         , Gg          , Gs          , Gg          , Gs          , Gs^Fp       , Gs^Fp       , Gs^Fms      , Gs^Fp       , Gg          , Gs^Fp       , Gg          , Gs^Fp       , Gs^Fp       , Gs^Fp       , Gg          , Gg          , Gg          , Gg          , Gg          , Gg          , Gg          , Gs          , Gg          , Hh          , Hh          , Hh          , Gg          , Gs          , Gs^Fp       , Gs          , Gs^Fp       , Gs          , Gs^Fp       , Gs^Fp       , Gg          , Gs^Fp       , Gg          , Gg          , Gg          
Gg          , Gg          , Gg          , Gg          , Gg          , Ww          , Ww          , Wwf         , Gg          , Gg          , Gs          , Gg          , Gs^Fms      , Gs^Fds      , Gs^Fds      , Gs^Fp       , Gg          , Gs^Fp       , Gg          , Gs^Fp       , Gs^Fp       , Gs^Fp       , Gg          , Gs          , Gg          , Gg          , Gg          , Gs          , Gs          , Gg          , Gs          , Hh          , Hh          , Hh          , Gs          , Gg          , Gs^Fp       , Gg          , Gs^Fms      , Gs          , Gs^Fds      , Gs^Fms      , Gg          , Gs^Fp       , Gs          , Gg          , Gs          
Gg          , Gg          , Gg          , Gg          , Gg          , Ww          , Ww          , Wwf         , Wwf         , Gg          , Gg          , Gg          , Gs^Fp       , Gs^Fds      , Gs^Fms      , Gs          , Gg          , Gg          , Gs          , Gg          , Gs^Fms      , Gs          , Gs          , Gs          , Gg          , Gs          , Gs          , Gs          , Gs^Fds      , Gs          , Gg          , Hh          , Gg          , Gs          , Gg          , Gs^Fms      , Gs^Fms      , Gg          , Gs^Fp       , Gs^Fds      , Gs^Fms      , Gs          , Gs^Fp       , Gs          , Gs^Fds      , Gs^Fp       , Gs^Fp       
Gs^Fp       , Gs^Fms      , Gs^Fms      , Gg          , Gg          , Ww          , Ww          , Ww          , Ww          , Gg          , Gg          , Gg          , Gs          , Gg          , Gs          , Gg          , Gg          , Gg          , Gg          , Gs^Fms      , Gs^Fds      , Gs^Fp       , Gg          , Gs^Fms      , Hh          , Gs          , Gg          , Gs          , Gs^Fms      , Gs^Fms      , Gs^Fp       , Gs          , Gg          , Gg          , Gs^Fds      , Gs^Fms      , Gg          , Gs          , Gs          , Gg          , Gg          , Gs          , Gs          , Gg          , Gs^Fms      , Gs^Fms      , Gs^Fp       
Gs^Fms      , Gs^Fms      , Gs^Fms      , Gg          , Gg          , Ww          , Ww          , Ww          , Ww          , Gg          , Gg          , Gg          , Gg          , Gs          , Gg          , Gs^Fp       , Gs^Fds      , Gg          , Gs          , Gs          , Gs^Fms      , Gs^Fds      , Gg          , Gg          , Gg          , Hh          , Gg          , Gg          , Gs^Fp       , Gg          , Gs^Fms      , Gg          , Gg^Vh       , Gs          , Gs          , Gs^Fds      , Gs          , Gs          , Gs          , Gg          , Gs          , Hh          , Gg          , Gs          , Gs^Fds      , Gs^Fds      , Gs^Fp       
Gs^Fds      , Gs^Fds      , Gs^Fms      , Gg^Vh       , Gg          , Ww          , Ww          , Wo          , Wo          , Ww          , Wwf         , Gg          , Gg          , Gg          , Hh          , Gg          , Gs          , Gs^Fms      , Gg          , Gg          , Gg          , Gg          , Gg          , Gs          , Gs^Fms      , Hh          , Gs          , Gg          , Gg          , Gs^Fp       , Gg          , Gs          , Gg          , Gg          , Gs          , Gs^Fms      , Gs          , Gg          , Gg          , Hh          , Hh^Vhh      , Hh          , Gg          , Gs          , Gs          , Gs^Fms      , Gs^Fms      
Gs^Fp       , Gs^Fms      , Gs^Fms      , Gs^Fp       , Gg          , Gg          , Gg          , Ww          , Ww          , Wo          , Wwf         , Wwf         , Wwf         , Gg          , Hh          , Hh^Vhh      , Gs^Fms      , Gs^Fms      , Gs^Fp       , Gs          , Gg          , Gs          , Gs^Fp       , Gs^Fms      , Gg          , Gg          , Gg          , Gg          , Gg          , Gg          , Gg          , Gs          , Gg          , Gs          , Gg          , Gg          , Gs^Fms      , Gg          , Gs^Fp       , Gg          , Gs^Fms      , Hh          , Hh          , Gs^Fp       , Gs^Fms      , Gs^Fds      , Gs^Fp       
Gs^Fp       , Gs^Fms      , Gg          , Gg          , Gs^Fms      , Gg          , Gg          , Gg          , Wwf         , Ww          , Wwf         , Ww          , Ww          , Gg          , Gg          , Hh          , Gs          , Gs^Fms      , Gs          , Gg          , Gs          , Gg          , Gg          , Gg          , Gg          , Gg          , Gg          , Gg          , Gg          , Gg          , Gg          , Gg          , Gg          , Gs          , Gg          , Gg          , Gs          , Gs^Fds      , Gs          , Gs          , Hh          , Gs^Fms      , Gg          , Gs          , Gs          , Gs          , Gs          
Gg          , Gg          , Gg          , Gs^Fp       , Gs^Fp       , Gg          , Gg          , Gg          , Wwf         , Wwf         , Ww          , Wo          , Ww          , Gg          , Gg          , Hh          , Gs          , Gg          , Gg          , Gg          , Gg          , Gg          , Gg          , Gg          , Gg          , Gg          , Ss          , Ss          , Ss          , Ss          , Ss          , Ss          , Ss          , Gg          , Gg          , Gg          , Gg          , Gs          , Gs          , Gg          , Gs          , Gg          , Gs^Fp       , Gg          , Gs          , Gs^Fp       , Gs^Fms      
Gg          , Gg          , Gg          , Gg          , Gg          , Gg          , Gg          , Gg          , Gg          , Wwf         , Ww          , Wo          , Ww          , Gg          , Gg          , Gg          , Gg          , Gg          , Gg          , Gg          , Gg          , Gg          , Gg          , Gg          , Ss          , Ss          , Ds          , Ds          , Ds          , Ds          , Ds          , Ds          , Ds          , Ss          , Ss          , Gg          , Gg          , Gg          , Gg          , Gg          , Gs^Fds      , Gs^Fms      , Gs^Fms      , Gg          , Gg          , Gs^Fms      , Gs^Fp       
Gg          , Gg          , Gg          , Gg          , Gg          , Gg          , Gg          , Gg          , Gg          , Gg          , Ww          , Wo          , Wo          , Ww          , Ww          , Gg          , Ss          , Gg          , Gg          , Gg          , Ss          , Gg          , Ss          , Ss          , Ds          , Ds          , Ch          , Ch          , Ch          , Ch          , Ch          , Ds          , Ds          , Ds          , Ss          , Gg          , Gg          , Gg          , Gg          , Gs          , Gg          , Gs^Fds      , Gg          , Gs^Fp       , Gs          , Gg          , Gg          
Gs^Fp       , Gs^Fms      , Gs^Fp       , Gg          , Gg          , Gg          , Gg          , Gg          , Hh          , Gg          , Gg          , Ww          , Ww          , Wo          , Ww          , Ww          , Ww          , Ss          , Ss          , Ss          , Ds          , Ss          , Ds          , Ds          , Ch          , Ch          , Rp          , Rp          , Rp          , Rp          , Rp          , Ch          , Ch          , Ds          , Ds          , Ss          , Ss          , Gg          , Gg          , Gg          , Gg          , Gs^Fms      , Gs          , Gs          , Hh          , Gg          , Gg          
Gs^Fp       , Gs^Fms      , Gs^Fms      , Gg          , Gs^Fp       , Gg          , Gg          , Gg          , Gg          , Hh          , Hh          , Gg          , Gg          , Ww          , Ww          , Ww          , Wo          , Ww          , Ds          , Ds          , Ds          , Ds          , Ch          , Ch          , Rp          , Rp          , Rp          , Rp^Vhc      , Rp          , Rp          , Rp^Vhc      , Rp          , Rp          , Ch          , Ch          , Ds          , Ss          , Gg          , Gg          , Gs          , Gg          , Gs          , Hh          , Hh          , Gg          , Gs^Fp       , Gs^Fp       
Gs^Fds      , Gs^Fds      , Gs^Fms      , Gs^Fp       , Gg          , Gg          , Gg          , Gg          , Gg          , Gg          , Hh          , Gg          , Gg          , Gg          , Gg          , Ww          , Wo          , Ww          , Ww          , Ds          , Ww          , Ch          , Rp          , Rp          , Rp^Vhc      , Rp          , Rp          , Rp          , Rp          , Rp          , Rp          , Rp          , Rp^Vhc      , Rp          , Ch          , Ds          , Ss          , Ss          , Gg          , Gg          , Gg          , Hh          , Hh          , Hh          , Gs^Fms      , Gg          , Gg          
Gs^Fp       , Gs^Fms      , Gg          , Gg          , Gg          , Gg          , Gg          , Gg          , Gg          , Gg          , Hh^Vhh      , Gg          , Gg          , Gg          , Gg          , Ww          , Ww          , Wo          , Ww          , Ww          , Wwf         , Wwf         , Wwf         , Rp          , Rp          , Rp          , Rp          , Rp          , Ch          , Rp          , Rp          , Rp          , Rp          , Rp          , Ch          , Ds          , Ss          , Ss          , Gg          , Gg          , Gg          , Hh          , Gg          , Gs^Fp       , Gs^Fms      , Gg          , Gg          
Gg          , Gg          , Gg          , Gg          , Gg          , Gg          , Gg          , Gg          , Hh          , Hh          , Hh          , Hh          , Gg          , Gg          , Gg          , Gg          , Gg          , Ww          , Ww          , Ww          , Wwf         , Wwf         , Ww          , Wwf         , Rp          , Rp          , Rp          , Ch          , 2 Kh        , Ch          , Rp          , Rp          , Rp          , Rp          , Ch          , Ds          , Ss          , Ss          , Gg          , Gg          , Gs          , Gg          , Gs          , Gs^Fds      , Gs^Fp       , Gs^Fms      , Gs^Fp       
Gs^Fp       , Gs^Fp       , Gs^Fms      , Gg          , Gs^Fp       , Gg          , Gg          , Gg          , Gg          , Hh          , Hh          , Hh          , Hh          , Gg          , Gg          , Gg          , Gg          , Gg          , Ch          , Ww          , Wwf         , Wwf         , Wwf         , Wwf         , Wwf         , Wwf         , Ch          , Rp          , Ch          , Rp          , Rp          , Rp          , Rp^Vhc      , Rp          , Ch          , Ds          , Ss          , Gg          , Gg          , Gg          , Gg          , Gg          , Gg          , Gs^Fp       , Gg          , Gg          , Gg          
Gs^Fp       , Gs^Fds      , Gs^Fms      , Gs^Fms      , Gg          , Gg          , Gg          , Gg          , Gg          , Gg          , Gg          , Gg          , Gg          , Gg          , Gg          , Gg          , Gg          , Gg          , Ch          , Rp          , Rp^Vhc      , Wwf         , Ww          , Wwf         , Ww          , Ww          , Ww          , Ch          , Ch          , Rp          , Rp^Vhc      , Rp          , Rp          , Rp          , Ch          , Ds          , Ss          , Ss          , Gg          , Gg          , Gg          , Gg          , Gs^Fms      , Gg^Vh       , Gg          , Gg          , Ww          
Gs^Fp       , Gs^Fp       , Gg          , Gs^Fp       , Gg          , Gg          , Ww          , Gg          , Ww          , Gg          , Wwf         , Gg          , Gg          , Gg          , Gg          , Gg          , Gg          , Gg          , Ch          , Rp          , Rp          , Rp          , Rp^Vhc      , Wwf         , Ww          , Ww          , Ww          , Ww          , Ww          , Ww          , Rp          , Rp          , Ch          , Ch          , Ds          , Ds          , Ss          , Ss          , Ss          , Gg          , Gg          , Gg          , Gg          , Gg          , Wwf         , Ww          , Ww          
Gg          , Gg          , Gg          , Gg          , Ww          , Ww          , Ww          , Wwf         , Wwf         , Wwf         , Ww          , Wwf         , Ww          , Gg          , Gg          , Gg          , Ww          , Gg          , Ch          , Rp          , Rp          , Rp          , Rp          , Ww          , Ww          , Ww          , Wo          , Ww          , Ww          , Ds          , Ds          , Ww          , Ww          , Ds          , Ds          , Ss          , Ss          , Ss          , Ss          , Ss          , Ss          , Gg          , Ww          , Wwf         , Ww          , Ww          , Wo          
Gg          , Gg          , Ww          , Ww          , Wo          , Ww          , Ww          , Ww          , Wwf         , Ww          , Wwf         , Ww          , Ww          , Ww          , Ww          , Ww          , Ww          , Ww          , Ww          , Ww          , Ww          , Rp^Vhc      , Ww          , Ww          , Ww          , Wo          , Wo          , Wo          , Ww          , Ds          , Ww          , Ww          , Wo          , Ww          , Ww          , Ss          , Ww          , Ss          , Ww          , Ss          , Wwf         , Ww          , Ww          , Wwf         , Wo          , Wo          , Ww          
Ww          , Ww          , Wo          , Wo          , Ww          , Ww          , Ww          , Ww          , Gg          , Ww          , Gg          , Ww          , Ww          , Wo          , Wo          , Wo          , Ww          , Ww          , Ww          , Ww          , Wo          , Ww          , Wo          , Ww          , Wo          , Wo          , Wo          , Wo          , Wo          , Ww          , Ww          , Wo          , Ww          , Wo          , Wo          , Ww          , Ww          , Ww          , Ww          , Ww          , Ww          , Wo          , Wo          , Wo          , Wwf         , Ww          , Ww          
Ww          , Ww          , Ww          , Ww          , Gg          , Gg          , Gg          , Gg          , Gg          , Gg          , Gg          , Gg          , Gg          , Ww          , Gg          , Ww          , Gg          , Ww          , Ww          , Ww          , Ww          , Wo          , Ww          , Wo          , Ww          , Ww          , Ww          , Ww          , Ww          , Ww          , Ww          , Ww          , Ww          , Ww          , Ww          , Ww          , Ww          , Ww          , Wwf         , Wwf         , Wwf         , Ww          , Ww          , Wwf         , Gg          , Gg          , Gs          
Ww          , Ww          , Ww          , Ww          , Gg          , Gg^Vh       , Gs^Fp       , Gg          , Gg          , Gg          , Gg          , Gg          , Gs          , Gg          , Hh          , Gg          , Gg          , Gg          , Hh          , Ww          , Gg          , Ww          , Gg          , Ww          , Ww          , Ww          , Gg          , Gg          , Gg          , Ww          , Gg          , Gg          , Gg          , Gg          , Gg          , Ww          , Ww          , Gg^Vh       , Gg          , Gg          , Gg^Vh       , Gg          , Wwf         , Ww          , Gg          , Gg          , Gg          
Ww          , Ww          , Gg          , Gg          , Gg          , Gg          , Gg          , Gg          , Gg          , Gg          , Gg          , Hh          , Hh          , Hh          , Hh          , Hh          , Gg          , Gg          , Gg          , Gg          , Gs          , Gg          , Gg          , Gg          , Gg          , Gg          , Gg          , Gg          , Gg          , Gg          , Gg          , Gs          , Gg          , Gg          , Gg          , Gg          , Gg          , Wwf         , Ww          , Gg          , Ww          , Wwf         , Gg          , Gg          , Gs^Fms      , Gg          , Gg          
Gg          , Gg          , Gs^Fp       , Gs^Fp       , Gg          , Gg          , Gg          , Gs          , Gs^Fp       , Gg          , Gs^Fms      , Gs          , Gs^Fp       , Hh          , Gg          , Gg          , Gg          , Gg          , Gs^Fp       , Gs          , Gs^Fp       , Gs^Fp       , Gs^Fms      , Gs^Fp       , Gg          , Gg          , Gg          , Gs          , Gs          , Gs          , Gg          , Gg          , Gg          , Gg          , Gs^Fms      , Gs^Fp       , Gs          , Gg          , Gs          , Ww          , Hh          , Ww          , Gg          , Gg          , Gs^Fms      , Gs^Fp       , Gs^Fp       
Gs^Fp       , Gs^Fp       , Gg          , Gg          , Gg          , Gg          , Gg          , Gs^Fp       , Gg          , Gs^Fms      , Gs^Fms      , Gs^Fp       , Hh          , Gs^Fp       , Gg          , Gs^Fp       , Gs^Fms      , Gs^Fp       , Gs          , Gs^Fms      , Gs          , Gs          , Gg          , Gs^Fp       , Gg          , Gs          , Gg          , Gg          , Gs^Fms      , Gs^Fp       , Gs^Fp       , Gs          , Gs^Fp       , Gs^Fp       , Gs^Fms      , Hh          , Gg          , Gs          , Gg          , Hh          , Hh          , Gg          , Gs          , Gs^Fms      , Gs^Fds      , Gs^Fds      , Gs^Fp       
Gg          , Gg          , Gg          , Gg          , Gg          , Gs^Fp       , Gg          , Gg          , Gg          , Gs^Fp       , Gg          , Gg          , Gg          , Gs^Fp       , Gg          , Gs^Fp       , Gg          , Gs          , Gs          , Gs^Fms      , Gs^Fds      , Gs          , Gs^Fp       , Gs^Fms      , Gg          , Gg          , Gs^Fp       , Gg          , Gs          , Gg          , Gg          , Gs^Fms      , Gs^Fms      , Gs^Fds      , Gs          , Gs          , Gs          , Gg          , Gs          , Gs          , Hh          , Gg          , Gg          , Gg          , Gs^Fms      , Gs^Fds      , Gs^Fms      
Gs^Fp       , Gs^Fp       , Gs^Fp       , Gg          , Gs^Fms      , Gs^Fds      , Gs^Fms      , Gg          , Gs^Fp       , Gs^Fp       , Gs^Fp       , Gg          , Gg^Vh       , Gg          , Gg          , Gg          , Gg          , Gg          , Gs          , Gg          , Gs^Fp       , Gs^Fds      , Gs^Fds      , Gs^Fms      , Gs^Fms      , Gs^Fp       , Gs          , Gs          , Gs^Fp       , Gs^Fp       , Gg          , Gs          , Gg          , Gs^Fms      , Gg          , Gs          , Gg          , Gg          , Gg          , Hh          , Gg          , Gg          , Gs          , Gs          , Gg          , Gg          , Gs          
Gg          , Gg          , Gg          , Gs^Fp       , Gg          , Gg          , Gg          , Gs^Fms      , Gg          , Gg          , Gg          , Gg          , Gs^Fp       , Gg          , Gg          , Gg          , Gg          , Gg          , Gg          , Gg          , Gg          , Gs^Fms      , Gg          , Gg          , Gg          , Gs^Fp       , Gs^Fp       , Gg          , Gg          , Gg          , Gg          , Gg          , Gs^Fp       , Gs^Fds      , Gs^Fms      , Gg          , Gs          , Gs          , Gg          , Hh          , Gs^Fp       , Gg          , Gs^Fp       , Gg          , Gs^Fms      , Gg          , Gg          
Gg          , Gg          , Gg          , Gg          , Gs^Fp       , Gg          , Gg          , Gs          , Gs          , Gs          , Gs          , Gg          , Gg          , Gs^Fp       , Gg          , Ce          , Ce          , Gg          , Gg          , Gs          , Gg          , Gg          , Gs^Fms      , Gg          , Gg          , Gg          , Gg          , Gs^Fms      , Gg          , Gg          , Hh          , Gg          , Gg          , Gs^Fms      , Gg          , Gg          , Gg          , Gs^Fms      , Gs^Fp       , Gs          , Gg          , Gg          , Gs^Fms      , Gs^Fp       , Gg          , Gs          , Gs          
Gg          , Gg          , Gs          , Gg          , Gg          , Gs^Fp       , Gg          , Hh          , Hh          , Gg          , Gg          , Gg          , Gg          , Gg          , Ce          , 1 Ke        , Ce          , Ce          , Gg          , Gs          , Gg          , Gg          , Gs^Fms      , Gg          , Gg          , Gg          , Gg          , Gg          , Gs          , Gs          , Hh          , Gg          , Gg          , Gs^Fp       , Gg          , Gs          , Gg          , Gg          , Gs          , Gs          , Gs^Fms      , Gs^Fds      , Gs^Fms      , Gs          , Gg          , Gs          , Gg          
Gg          , Gg          , Gs          , Gg          , Gg          , Gg          , Gg          , Hh          , Gg          , Gs^Fms      , Gs^Fp       , Gg          , Gg          , Gg          , Gg          , Ce          , Gs          , Gg          , Gs          , Gs          , Gs^Fms      , Gs^Fds      , Gg          , Gs          , Gg          , Gs          , Gs^Fp       , Gg          , Gg          , Hh          , Gg          , Hh          , Hh          , Gs^Fms      , Gs^Fp       , Hh          , Gg          , Gg          , Gg          , Gs^Fp       , Gs^Fp       , Gs^Fds      , Gg^Vh       , Gs          , Gs          , Gg          , Gs          
Gg          , Gg          , Gg          , Hh          , Hh          , Hh          , Hh          , Hh          , Hh          , Gg          , Hh^Vhh      , Gs^Fp       , Gs^Fms      , Gg          , Gg          , Gg          , Gg          , Gs          , Gs^Fp       , Gs^Fms      , Gg          , Gs          , Gg          , Gg          , Gs          , Gg          , Gs^Fms      , Gs^Fms      , Hh          , Hh          , Hh^Vhh      , Hh          , Hh          , Gs^Fms      , Gg          , Gg          , Gg          , Gg          , Gg          , Gs^Fms      , Gg          , Gg          , Gg          , Gg          , Hh          , Gg          , Gg          
Gg          , Gg          , Gg          , Hh          , Gg          , Hh          , Gg          , Gg          , Gg          , Gg          , Gs^Fp       , Hh          , Gs^Fds      , Gg          , Gg          , Gg          , Gs^Fms      , Gg          , Gs^Fms      , Gs^Fp       , Gg          , Gs^Fp       , Gg          , Gs^Fms      , Gs^Fp       , Gs^Fds      , Gs^Fms      , Gs^Fp       , Hh          , Gs          , Gg          , Gg          , Gg          , Hh          , Gg          , Gs          , Gs          , Gs^Fp       , Gs^Fp       , Gs          , Gg          , Gs          , Hh          , Gs          , Gg          , Hh          , Hh          
Gg          , Gg          , Gg          , Gg          , Gg          , Gg          , Gs          , Gs          , Gs          , Gs^Fms      , Gg          , Gs^Fp       , Gs^Fms      , Gs^Fp       , Gg          , Gs          , Gg          , Gs^Fms      , Gg          , Gg          , Gg          , Gs          , Gg          , Gg          , Gs^Fms      , Gs^Fms      , Gg          , Gg          , Gg          , Gs^Fp       , Gg          , Gg          , Gg          , Gs          , Gg          , Gg          , Gs          , Gg          , Gs^Fp       , Gs          , Gs          , Hh          , Gg          , Gg          , Gg          , Hh          , Hh          
Gg          , Gg          , Gg          , Gg          , Gg          , Gg          , Gg          , Gg          , Gs          , Gs^Fp       , Gg          , Gs^Fp       , Gs^Fp       , Gs^Fp       , Gg          , Gg          , Gg          , Gs^Fp       , Gg          , Gg          , Gg          , Gg          , Gg          , Gg          , Gs^Fp       , Gs^Fp       , Gg          , Gg          , Gg          , Gs^Fp       , Gg          , Gg          , Gs          , Gg          , Gg          , Gg          , Gg          , Gs          , Gs^Fp       , Gg          , Gg          , Hh          , Gs          , Gg          , Gg          , Hh          , Hh          
