border_size=1
usage=map

Gs^Fds      , Gs^Fms      , Hh          , Gg          , Gg          , Gg          , Ce          , Rd          , Gg          , Gs^Fds      , Gs^Fds      , Gs^Fds      , Gs^Fp       , Gs^Fp       , Hh          , Hh          , Mm          , Hh          , Hh          , Hh          , Hh          , Wo          , Wo          , Hh          , Hh          , Mm          , Mm          , Mm          , Mm          , Mm          , Mm          , Mm          
Gs^Fds      , Gs^Fms      , Hh          , Gg          , Gg          , Gg          , 1 Ke        , Rd          , Rd          , Gs^Fms      , Gs^Fp       , Gs^Fms      , Gs^Fp       , Gs^Fp       , Hh          , Hh          , Mm          , Hh          , Hh          , Hh          , Hh          , Wo          , Wo          , Hh          , Hh          , Mm          , Mm          , Mm          , Mm          , Mm          , Mm          , Mm          
Hh          , Hh          , Gg          , Gg          , Gg          , Ce          , Ce          , Ce          , Rd          , Gs^Fp       , Gg          , Gs^Fp       , Gs^Fp       , Gs^Fp       , Hh          , Mm          , Mm          , Mm          , Hh          , Hh          , Wo          , Wo          , Wo          , Wo          , Hh          , Mm          , Mm          , Mm          , Mm          , Mm          , Mm^Xm       , Mm^Xm       
Hh          , Hh          , Hh          , Gg          , Hh          , Gg          , Hh          , Gg          , Rd          , Gg          , Gg          , Gg          , Gg          , Gg          , Hh          , Mm          , Mm          , Mm          , Mm          , Hh          , Wo          , Wo          , Wo          , Wo          , Hh          , Mm          , Mm          , Mm          , Mm          , Mm^Xm       , Mm          , Mm          
Gg          , Gg          , Gg          , Gg          , Gs^Fp       , Hh          , Gg          , Hh^Vhh      , Rd          , Hh          , Gg          , Gg          , Gs^Fp       , Gg          , Hh          , Mm          , Mm          , Mm          , Hh          , Hh          , Wo          , Wo          , Hh          , Wo          , Hh          , Mm          , Mm          , Mm          , Mm          , Mm^Xm       , Mm^Xm       , Mm^Xm       
Gg          , Gg          , Gg^Vh       , Gs^Fp       , Gg          , Hh          , Gg          , Gg          , Rd          , Hh          , Hh          , Hh          , Gg          , Gg          , Hh          , Mm          , Hh          , Hh          , Gg          , Hh          , Hh          , Hh          , Mm          , Hh          , Hh          , Mm          , Mm          , Mm          , Mm          , Mm^Xm       , Mm^Xm       , Mm^Xm       
Hh          , Hh          , Hh          , Hh          , Hh          , Hh          , Hh          , Gg          , Gg          , Rd          , Rd          , Gg^Vh       , Gg          , Mm          , Gg          , Hh          , Gg          , Gg          , Gs^Fp       , Hh          , Hh          , Mm          , Mm          , Mm          , Mm          , Mm          , Mm^Xm       , Mm^Xm       , Mm^Xm       , Mm          , Mm^Xm       , Mm^Xm       
Hh          , Hh          , Mm          , Mm          , Mm          , Mm          , Hh          , Hh          , Hh          , Hh          , Gg          , Rd          , Rd          , Gg          , Gg          , Gs^Fp       , Gs^Fp       , Gs^Fp       , Gg^Vh       , Hh          , Mm          , Mm          , Mm          , Mm          , Mm          , Mm^Xm       , Mm          , Mm          , Mm          , Mm^Xm       , Mm^Xm       , Mm^Xm       
Mm          , Mm          , Mm          , Hh          , Hh          , Mm          , Hh          , Hh          , Hh          , Hh          , Hh          , Hh          , Hh          , Rd          , Hh          , Gg          , Gg          , Gg          , Gg          , Hh          , Hh          , Mm          , Mm          , Mm          , Mm          , Mm^Xm       , Mm^Xm       , Mm^Xm       , Mm^Xm       , Mm^Xm       , Mm^Xm       , Mm^Xm       
Hh          , Hh          , Mm          , Hh          , Mm          , Mm          , Mm          , Mm          , Hh          , Mm          , Hh          , Mm          , Hh          , Rd          , Ce          , Gg          , Hh          , Hh          , Hh          , Hh          , Mm          , Mm          , Cud         , Mm^Xm       , Mm^Xm       , Mm^Xm       , Mm          , Mm^Xm       , Mm^Xm       , Mm          , Mm          , Mm          
Mm          , Mm          , Mm          , Mm          , Mm          , Mm          , Mm          , Mm          , Mm          , Hh          , Hh          , Mm          , Hh          , Ce          , Ce          , Hh          , Mm          , Mm          , Mm          , Hh          , Mm          , Cud         , 3 Kud       , Cud         , Mm          , Mm          , Mm          , Mm          , Mm^Xm       , Mm          , Mm^Xm       , Mm^Xm       
Mm^Xm       , Mm^Xm       , Mm^Xm       , Mm          , Mm^Xm       , Mm          , Mm^Xm       , Mm          , Mm^Xm       , Mm          , Mm          , Mm          , Mm          , Hh          , Rr          , Hh          , Mm          , Mm          , Mm          , Mm^Vhh      , Mm          , Mm          , Cud         , Cud         , Cud         , Mm^Xm       , Mm          , Mm          , Mm^Xm       , Mm^Xm       , Mm          , Mm          
Mm^Xm       , Mm^Xm       , Mm          , Mm^Xm       , Mm          , Mm^Xm       , Mm^Xm       , Mm^Xm       , Mm          , Mm          , Mm          , Mm          , Mm          , Mm          , Hh          , Rr          , Hh          , Mm          , Mm          , Mm          , Mm          , Mm          , Mm          , Cud         , Mm^Xm       , Mm^Xm       , Mm          , Mm          , Mm          , Mm^Xm       , Mm^Xm       , Mm^Xm       
Mm          , Mm          , Mm          , Mm^Xm       , Mm^Xm       , Mm          , Mm          , Mm          , Mm          , Mm          , Mm          , Mm          , Mm          , Mm          , Hh          , Rr          , Gg          , Hh          , Mm          , Hh          , Hh          , Hh          , Hh^Vhh      , Mm          , Mm          , Hh          , Mm          , Mm          , Mm          , Mm^Xm       , Mm          , Mm          
Mm^Xm       , Mm^Xm       , Mm^Xm       , Mm^Xm       , Mm          , Mm          , Mm          , Mm          , Mm          , Hh          , Hh          , Hh          , Hh          , Hh          , Hh          , Rr          , Rr          , Hh          , Hh          , Hh          , Gg          , Hh          , Hh          , Mm          , Mm          , Mm          , Hh          , Mm          , Mm          , Mm^Xm       , Mm          , Mm          
Mm          , Mm          , Mm^Xm       , Mm^Xm       , Mm          , Mm          , Mm          , Hh          , Mm          , Hh          , Hh          , Hh          , Hh          , Hh          , Gg          , Gg          , Rr          , Hh          , Hh          , Hh          , Gg          , Hh          , Hh          , Mm          , Mm          , Hh          , Mm          , Mm          , Mm          , Mm          , Mm          , Mm          
Mm^Xm       , Mm^Xm       , Mm          , Mm          , Mm          , Mm          , Mm          , Mm          , Hh          , Mm          , Hh          , Mm          , Hh          , Hh          , Gg          , Gg          , Rr          , Gg          , Hh          , Hh          , Hh          , Gg          , Gg          , Hh          , Hh          , Hh          , Mm          , Hh^Vhh      , Hh          , Mm          , Mm          , Mm          
Mm          , Mm          , Mm          , Mm          , Hh          , Mm          , Hh^Vhh      , Hh          , Hh          , Hh          , Hh          , Hh          , Gg          , Hh          , Gg          , Gg          , Rr          , Hh          , Hh          , Hh          , Mm          , Hh          , Gg          , Hh          , Hh          , Hh          , Hh          , Hh          , Mm          , Hh          , Mm          , Mm          
Mm          , Mm          , Mm          , Hh          , Gg          , Mm          , Hh          , Mm          , Hh          , Gg          , Gg          , Gg          , Hh          , Gg          , Gg          , Gg          , Rr          , Gg          , Hh          , Mm          , Mm          , Hh          , Hh          , Gg          , Gg          , Mm          , Gg          , Hh          , Hh          , Mm          , Hh          , Hh          
Mm          , Mm          , Mm          , Hh          , Gg          , Gg          , Hh          , Mm          , Hh          , Gg          , Gg          , Gg          , Hh          , Gg          , Gg          , Gg          , Rr          , Gg          , Hh          , Mm          , Mm          , Hh          , Hh          , Hh          , Hh          , Gg          , Hh          , Hh          , Hh          , Hh          , Gg          , Gg          
Mm          , Mm          , Mm          , Mm          , Mm          , Gg          , Hh          , Mm          , Hh          , Gg          , Gg          , Gg          , Gg          , Gg          , Gg          , Gg          , Gg          , Rr          , Gg          , Hh          , Hh          , Hh          , Mm          , Mm          , Mm          , Hh          , Hh          , Hh          , Hh          , Gg          , Gg          , Gg          
Mm          , Mm          , Mm          , Mm          , Mm          , Hh          , Mm          , Hh          , Gg          , Hh          , Hh          , Hh          , Hh          , Gg          , Hh          , Hh          , Gg          , Rr          , Rr          , Hh          , Gg          , Hh          , Mm          , Mm          , Mm          , Mm          , Mm          , Mm          , Hh          , Gg          , Gg          , Gg          
Mm          , Mm          , Mm          , Mm          , Mm          , Mm          , Mm          , Hh          , Gg          , Gg          , Hh          , Gg          , Gg          , Hh          , Gg          , Gg          , Gg          , Gg          , Rr          , Gg          , Gg          , Hh          , Hh          , Mm          , Mm          , Mm          , Hh          , Mm          , Hh          , Hh          , Gg          , Gg          
Mm          , Mm          , Hh          , Mm          , Mm          , Hh          , Hh          , Hh          , Hh          , Gg          , Gg          , Hh          , Gg          , Gg          , Gg^Gvs      , Gg^Gvs      , Gg          , Rr          , Chr         , Rr          , Rr          , Hh          , Hh          , Hh          , Hh          , Hh          , Hh          , Hh          , Hh          , Hh          , Gg          , Gg          
Mm          , Mm          , Hh          , Hh          , Hh          , Mm          , Mm          , Hh          , Mm          , Hh          , Hh          , Gg          , Gg          , Gg^Gvs      , Gg^Gvs      , Gg^Gvs      , Gg          , Rr          , Chr         , Chr         , Gg^Vh       , Rr          , Rr          , Hh          , Gg          , Hh          , Gg          , Gg          , Gg          , Gg          , Gg          , Gg          
Hh          , Hh          , Gg          , Gg          , Mm          , Mm          , Mm          , Hh^Vhh      , Gg          , Mm          , Gg          , Hh          , Gg          , Gg^Gvs      , Gg          , Gg^Gvs      , Gg          , Rr          , Gg^Vh       , Gg          , Gg          , Chr         , Chr         , Rr          , Rr          , Rr          , Rr          , Gg^Vh       , Rr          , Rr          , Rr          , Rr          
Hh          , Hh          , Gg          , Gg          , Hh          , Hh          , Hh          , Hh          , Gg          , Gg          , Hh          , Hh          , Hh          , Gg          , Hh          , Gg          , Gg          , Rr          , Chr         , Gg          , 2 Kh        , Chr         , Gg          , Gg          , Gg          , Gg          , Gg          , Rr          , Gg          , Gg          , Gg          , Gg          
Gg          , Gg          , Gg          , Gg          , Gg          , Gg          , Gg          , Gg          , Gg          , Hh          , Mm          , Mm          , Mm          , Mm          , Hh          , Gg          , Rr          , Rr          , Chr         , Chr         , Gg          , Gg          , Gg^Gvs      , Gg^Gvs      , Gg^Gvs      , Gg^Gvs      , Gg^Gvs      , Gg          , Gg^Gvs      , Gg^Gvs      , Gg^Gvs      , Gg^Gvs      
Gg          , Gg          , Gg          , Gg          , Gg          , Gg          , Gg          , Gg          , Gg          , Hh          , Mm          , Mm          , Hh          , Hh          , Gg          , Gg          , Rr          , Gg          , Gg          , Gg          , Gg^Gvs      , Gg^Gvs      , Gg^Gvs      , Gg^Gvs      , Gg^Gvs      , Gg^Gvs      , Gg^Gvs      , Gg^Gvs      , Gg^Gvs      , Gg^Gvs      , Gg^Gvs      , Gg^Gvs      
Gg          , Gg          , Gg          , Gg          , Gg          , Gg          , Gg          , Gg          , Gg          , Hh          , Hh          , Hh          , Gg          , Gg          , Gg          , Gg^Vh       , Rr          , Gg          , Gg^Gvs      , Gg^Gvs      , Gg^Gvs      , Gg^Gvs      , Gg^Gvs      , Gg^Gvs      , Gg^Gvs      , Gg^Gvs      , Gg^Gvs      , Gg^Gvs      , Gg^Gvs      , Gg^Gvs      , Gg^Gvs      , Gg^Gvs      
Gg          , Gg          , Gg          , Gg          , Gg          , Gg          , Gg          , Gg          , Gg          , Hh          , Hh          , Hh          , Gg          , Gg          , Gg          , Gg          , Rr          , Gg          , Gg^Gvs      , Gg^Gvs      , Gg^Gvs      , Gg^Gvs      , Gg^Gvs      , Gg^Gvs      , Gg^Gvs      , Gg^Gvs      , Gg^Gvs      , Gg^Gvs      , Gg^Gvs      , Gg^Gvs      , Gg^Gvs      , Gg^Gvs      
