border_size=1
usage=map

Gs          , Gg          , Gs          , Gs          , Gs          , Gg          , Gg          , Gg          , Gg          , Gs          , Gs          , Gg          , Gg          , Gg          , Gs          , Gg          , Gg          , Gg          , Gg          , Gg          , Gg          , Rr          , Gg          , Gg          , Gg          , Gs^Fdf      , Gs          , Gg          , Gs          , Gg          , Gs^Fdf      , Gg          , Gs^Fdf      , Gs^Fdf      , Gs^Fdf      , Gs^Fdf      , Hh^Fdf      , Hh^Fdf      
Gg          , Gs          , Gg          , Gs          , Gs          , Gs          , Gs          , Gs          , Gs          , Gg          , Gs          , Gs          , Gs          , Gs          , Gs          , Gg          , Gg          , Gg          , Ce          , Gg          , Ce          , Rr          , Gg          , Gs          , Gs          , Gs^Fdf      , Gg          , Gs          , Gs          , Gs          , Gs^Fdf      , Gg          , Gs^Fdf      , Gs^Fdf      , Gs^Fdf      , Gs^Fdf      , Gs^Fdf      , Hh^Fdf      
Gg          , Gg          , Gs          , Gg          , Ggf         , Gg          , Gs          , Gs          , Gg          , Gs          , Gg          , Gs          , Gg          , Gg          , Gg          , Gs          , Gg          , Gg          , Ce          , 1 Ke        , Ce          , Rr          , Gg          , Gg          , Gs^Fdf      , Gs          , Hh          , Hh          , Hh^Fdf      , Gg          , Gs^Fdf      , Gs^Fdf      , Gs          , Gg          , Hh^Fdf      , Hh^Fdf      , Gs^Fdf      , Hh^Fdf      
Gg          , Gs          , Gg          , Gs          , Gs          , Gs          , Gg          , Gg          , Gs          , Ggf         , Gs          , Gg          , Ggf         , Gg          , Gg          , Gs          , Ggf         , Gg          , Gg          , Ce          , Ce          , Rr          , Gg          , Gg          , Gg          , Gg          , Hh          , Hh^Fdf      , Gg          , Gs^Fdf      , Gg          , Gs          , Gs          , Gs^Fdf      , Gs^Fdf      , Hh^Fdf      , Gs^Fdf      , Hh^Fdf      
Gs          , Gs          , Gs          , Gg          , Gs          , Gs          , Ggf         , Gs          , Gs          , Gs          , Ggf         , Gg          , Gg          , Gs          , Gs          , Gs          , Gs          , Gg          , Gg          , Gg          , Rr          , Rr          , Gg          , Gg          , Gs          , Gs^Fdf      , Gs          , Hh          , Gg          , Gg          , Hh          , Hh          , Hh          , Hh^Fdf      , Gs^Fdf      , Gs^Fdf      , Gs^Fdf      , Gs^Fdf      
Gs          , Gs          , Gs          , Gs          , Gg          , Gg          , Gg          , Gg          , Gs          , Gs          , Gs          , Ggf         , Gg          , Gg          , Gg          , Gg          , Ggf         , Ggf         , Gg          , Gg          , Rr          , Gg          , Gg          , Gg          , Gs          , Gs^Fdf      , Gs^Fdf      , Gs          , Gs^Fdf      , Gs          , Gs          , Hh^Fdf      , Gg          , Gs^Fdf      , Hh^Fdf      , Gs          , Gs^Fdf      , Gs^Fdf      
Gg          , Gs          , Gg          , Gs          , Gg          , Gs          , Gs          , Gs          , Gg          , Gs          , Gg          , Gg          , Gg          , Gg          , Gg          , Gg          , Gg          , Gg          , Gg          , Gg          , Rr          , Gg          , Gg          , Gg          , Ggf         , Gs          , Gg          , Gs          , Gg          , Gs          , Gs          , Gs^Fdf      , Gs^Fdf      , Gs^Fdf      , Hh          , Gg          , Gs^Fdf      , Hh^Fdf      
Gg          , Gs          , Gs          , Gs          , Gs          , Gg          , Ggf         , Gg          , Gg          , Gg          , Ggf         , Gg          , Gg          , Gg          , Ce          , Gg          , Ce          , Gg          , Ce          , Gg          , Rr          , Gg          , Ce          , Gg          , Gg          , Gg          , Gg          , Gg          , Gs          , Gg          , Hh          , Gs^Fdf      , Gg          , Gg          , Hh          , Gs^Fdf      , Gs^Fdf      , Gs^Fdf      
Gg          , Gs          , Gg          , Gs          , Gs          , Gs          , Ggf         , Gg          , Gg          , Gg          , Gg          , Gg          , Ce          , Ce          , Gg          , Ce          , Gg          , Ce          , Gg          , Gg          , Rr          , Gg          , Gg          , Ce          , Ce          , Gg          , Gg          , Gs^Fdf      , Gs          , Gs          , Hh          , Gg          , Gs^Fdf      , Gg          , Gs^Fdf      , Gg          , Gs^Fdf      , Gs^Fdf      
Gg          , Gg          , Gg          , Gg          , Gg          , Gg          , Gg          , Ggf         , Gg          , Gg          , Gg          , Ce          , Gg          , Gg          , Re^Gvs      , Gg          , Re^Gvs      , Gg          , Gg          , Gg^Vh       , Rr          , Gg          , Re^Gvs      , Gg          , Gg          , Ce          , Ce          , Gg          , Gg          , Gg          , Hh^Fdf      , Gg          , Gg          , Gs          , Gs          , Gg          , Gg          , Gg          
Gg          , Gg          , Gg          , Gg          , Gg          , Gg          , Gg          , Gg          , Gg          , Gg          , Ce          , Ce          , Gg          , Gg          , Re^Gvs      , Re^Gvs      , Re^Gvs      , Re^Gvs      , Gg          , Rr          , Gg          , Gg          , Re^Gvs      , Re^Gvs      , Re^Gvs      , Gg          , Gg          , Ce          , Gg          , Hh          , Gg          , Hh          , Hh          , Gg          , Gs          , Gs          , Gs^Fdf      , Gs^Fdf      
Gg          , Gg          , Gg          , Gg          , Gg          , Gg          , Ce          , Ce          , Ce          , Ce          , Gg          , Gg          , Gg          , Re^Gvs      , Re^Gvs      , Re^Gvs      , Re^Gvs      , Re^Gvs      , Gg          , Rr          , Gg          , Re^Gvs      , Re^Gvs      , Re^Gvs      , Re^Gvs      , Gg          , Gg          , Ce          , Ce          , Gg          , Gs^Fdf      , Gg          , Gg          , Gg          , Gs^Fdf      , Gg          , Gs^Fdf      , Gs^Fdf      
Gg          , Gg          , Gg          , Gg          , Ce          , Ce          , Gg          , Gg          , Gg          , Gg          , Re^Gvs      , Gg          , Re^Gvs      , Re^Gvs      , Re^Gvs      , Re^Gvs      , Re^Gvs      , Re^Gvs      , Gg          , Rr          , Gg          , Re^Gvs      , Re^Gvs      , Re^Gvs      , Re^Gvs      , Re^Gvs      , Re^Gvs      , Gg          , Ce          , Gg          , Gg          , Gs          , Gs          , Gs^Fdf      , Gs^Fdf      , Gs          , Gs^Fdf      , Gs^Fdf      
Gg          , Gg          , Gg          , Gg          , Ce          , Gg          , Re^Gvs      , Re^Gvs      , Re^Gvs      , Re^Gvs      , Re^Gvs      , Re^Gvs      , Re^Gvs      , Re^Gvs      , Re^Gvs      , Re^Gvs      , Re^Gvs      , Re^Gvs      , Gg          , Rr          , Gg          , Re^Gvs      , Re^Gvs      , Re^Gvs      , Re^Gvs      , Re^Gvs      , Re^Gvs      , Gg          , Gg          , Ce          , Ce          , Gg          , Gg          , Gs          , Gs          , Gs^Fdf      , Gs          , Gg          
Rr          , Rr          , Rr          , Gg          , Gg          , Gg          , Re^Gvs      , Re^Gvs      , Re^Gvs      , Re^Gvs      , Re^Gvs      , Re^Gvs      , Gg^Vh       , Re^Gvs      , Re^Gvs      , Re^Gvs      , Re^Gvs      , Re^Gvs      , Gg^Vh       , Rr          , Gg          , Re^Gvs      , Re^Gvs      , Re^Gvs      , Gg^Vh       , Re^Gvs      , Re^Gvs      , Re^Gvs      , Re^Gvs      , Gg          , Ce          , Gg          , Gs^Fdf      , Gs          , Gs^Fdf      , Gg          , Rr          , Rr          
Gg          , Gg          , Gg          , Rr          , Rr          , Gg          , Gg          , Re^Gvs      , Re^Gvs      , Re^Gvs      , Re^Gvs      , Re^Gvs      , Re^Gvs      , Re^Gvs      , Re^Gvs      , Re^Gvs      , Re^Gvs      , Re^Gvs      , Gg          , Rr          , Gg          , Re^Gvs      , Re^Gvs      , Re^Gvs      , Re^Gvs      , Re^Gvs      , Re^Gvs      , Re^Gvs      , Re^Gvs      , Gg          , Ce          , Gg          , Gg          , Gs          , Rr          , Rr          , Gg          , Gg          
Gg          , Gg          , Gg          , Gg          , Gg          , Rr          , Rr          , Gg          , Gg          , Re^Gvs      , Re^Gvs      , Re^Gvs      , Re^Gvs      , Re^Gvs      , Re^Gvs      , Re^Gvs      , Re^Gvs      , Re^Gvs      , Gg          , Rr          , Gg          , Re^Gvs      , Re^Gvs      , Re^Gvs      , Re^Gvs      , Re^Gvs      , Re^Gvs      , Re^Gvs      , Re^Gvs      , Gg          , Gg          , Gg          , Rr          , Rr          , Gs^Fdf      , Gg          , Ww          , Ww          
Gg          , Gg          , Gg          , Ce          , Gg          , Gg          , Gg          , Rr          , Rr          , Gg          , Gg          , Re^Gvs      , Re^Gvs      , Re^Gvs      , Re^Gvs      , Re^Gvs      , Gg          , Gg          , Ch          , Rr          , Ch          , Gg          , Gg          , Re^Gvs      , Gg          , Re^Gvs      , Gg          , Re^Gvs      , Gg          , Gg          , Gg          , Rr          , Gg          , Gg          , Ww          , Gg          , Ww          , Ww          
Gg          , Gg          , Gg          , Ce          , Gg          , Re^Gvs      , Re^Gvs      , Gg          , Gg          , Rr          , Rr          , Gg          , Gg          , Re^Gvs      , Gg          , Gg          , Ch          , Ch          , Gg          , Rr          , Gg          , Ch          , Ch          , Gg          , Rr          , Gg          , Rr          , Gg          , Rr          , Rr          , Rr          , Rr          , Gg          , Wwf         , Ww          , Ww          , Wo          , Wo          
Gg          , Gg          , Gg          , Ce          , Gg          , Re^Gvs      , Re^Gvs      , Re^Gvs      , Re^Gvs      , Gg          , Gg          , Rr          , Rr          , Gg          , Ch          , Ch          , Gg          , Gg          , Gg          , Rr          , Gg          , Gg          , Rr          , Rr          , Gg          , Rr          , Gg          , Rr          , Gg          , Gg          , Gg          , Gg          , Gg          , Wwf         , Ww          , Wo          , Ww          , Ww          
Gg          , Gg          , Gg          , Ce          , Gg          , Re^Gvs      , Re^Gvs      , Gg^Vh       , Re^Gvs      , Re^Gvs      , Re^Gvs      , Gg          , Gg          , Rr          , Rr          , Gg          , Gg          , Gg          , Gg          , Rr          , Gg^Vh       , Rr          , Gg          , Ch          , Gg          , Gg          , Gg          , Gg          , Ww          , Ww          , Ww          , Wwf         , Ww          , Ww          , Wo          , Ww          , Wwf         , Wwf         
Gg          , Gg          , Gg          , Ce          , Gg          , Gg          , Gg          , Re^Gvs      , Gg          , Re^Gvs      , Re^Gvs      , Re^Gvs      , Gg          , Ch          , Gg          , Rr          , Rr          , Gg^Vh       , Rr          , Rr          , Rr          , Rr          , Gg          , Ch          , Gg          , Gg          , Ww          , Ww          , Wo          , Wo          , Wo          , Ww          , Wo          , Wo          , Ww          , Ww          , Gg          , Gg          
Gg          , Gg          , Rr          , Gg          , Rr          , Rr          , Rr          , Gg          , Rr          , Gg          , Gg          , Gg          , Gg          , Ch          , Gg          , Gg          , Gg^Vh       , Rr          , Rr          , Ch          , Ch          , Gg          , Gg          , Wwf         , Ww          , Ww          , Wo          , Wo          , Ww          , Ww          , Ww          , Ww          , Ww          , Ww          , Gg          , Gg          , Gg          , Gg          
Rr          , Rr          , Gg          , Rr          , Gg          , Gg          , Gg          , Rr          , Gg          , Rr          , Rr          , Rr          , Rr          , Rr          , Rr          , Rr          , Rr          , Rr          , Ch          , 2 Kh        , Ch          , Gg          , Ww          , Ww          , Wo          , Wo          , Ww          , Ww          , Gg          , Gg          , Gg          , Gg          , Gg          , Ww          , Ce          , Gg          , Gg          , Gg          
Gg          , Gg          , Ww          , Gg          , Ww          , Ww          , Ww          , Gg          , Ww          , Gg          , Gg          , Gg          , Gg          , Ch          , Gg          , Gg          , Gg          , Gg          , Gg          , Ch          , Gg          , Gg          , Ww          , Wo          , Ww          , Ww          , Gg          , Gg          , Re^Gvs      , Re^Gvs      , Re^Gvs      , Re^Gvs      , Re^Gvs      , Gg          , Gg          , Ce          , Gg          , Gg          
Ww          , Ww          , Wo          , Ww          , Ww          , Ww          , Wo          , Ww          , Ww          , Ww          , Ww          , Ww          , Wwf         , Ch          , Wwf         , Gg          , Wwf         , Wwf         , Ww          , Rr          , Ww          , Gg^Vh       , Ww          , Ww          , Ww          , Gg          , Re^Gvs      , Re^Gvs      , Re^Gvs      , Re^Gvs      , Re^Gvs      , Re^Gvs      , Re^Gvs      , Re^Gvs      , Gg          , Ce          , Gg          , Gg          
Wo          , Wo          , Ww          , Ww          , Ww          , Wo          , Ww          , Ww          , Ww          , Ww          , Ww          , Wo          , Wwf         , Wwf         , Wwf         , Ww          , Wo          , Wwf         , Ww          , Ww^Bw|      , Ww          , Ww          , Wo          , Ww          , Gg          , Gg          , Re^Gvs      , Re^Gvs      , Re^Gvs      , Re^Gvs      , Re^Gvs      , Re^Gvs      , Re^Gvs      , Re^Gvs      , Gg          , Ce          , Gg          , Gs          
Ww          , Ww          , Gg          , Ww          , Gg          , Ww          , Gg          , Gg          , Gg          , Gg          , Gg          , Ww          , Ww          , Ww          , Ww          , Ww          , Ww          , Ww          , Ww          , Ww^Bw|      , Ww          , Wo          , Ww          , Ww          , Gg          , Re^Gvs      , Re^Gvs      , Re^Gvs      , Re^Gvs      , Gg^Vh       , Re^Gvs      , Re^Gvs      , Re^Gvs      , Re^Gvs      , Gg          , Ce          , Gg          , Gg          
Gg          , Gg          , Gg          , Gg          , Gg          , Ce          , Gg          , Re^Gvs      , Re^Gvs      , Re^Gvs      , Re^Gvs      , Gg          , Gg          , Gg          , Gg          , Gg          , Gg          , Gg          , Gg          , Rr          , Gg^Vh       , Ww          , Gg          , Gg          , Re^Gvs      , Re^Gvs      , Re^Gvs      , Re^Gvs      , Re^Gvs      , Re^Gvs      , Re^Gvs      , Re^Gvs      , Re^Gvs      , Re^Gvs      , Gg          , Ce          , Gg          , Gg          
Gg          , Gg          , Ggf         , Gg          , Gg          , Ce          , Gg          , Re^Gvs      , Re^Gvs      , Gg^Vh       , Re^Gvs      , Re^Gvs      , Re^Gvs      , Re^Gvs      , Re^Gvs      , Re^Gvs      , Re^Gvs      , Re^Gvs      , Gg          , Rr          , Gg          , Gg          , Re^Gvs      , Re^Gvs      , Re^Gvs      , Re^Gvs      , Re^Gvs      , Re^Gvs      , Re^Gvs      , Re^Gvs      , Re^Gvs      , Re^Gvs      , Gg          , Gg          , Ce          , Ce          , Gg          , Gg          
Ggf         , Gs          , Gs          , Gg          , Gg          , Ce          , Ce          , Gg          , Gg          , Re^Gvs      , Gg          , Re^Gvs      , Gg          , Re^Gvs      , Gg          , Re^Gvs      , Gg          , Re^Gvs      , Gg          , Rr          , Rr          , Gg          , Gg          , Re^Gvs      , Gg          , Re^Gvs      , Gg          , Gg          , Gg          , Gg          , Gg          , Gg          , Ce          , Ce          , Gg          , Gg          , Gg          , Gs          
Gg          , Gg          , Gs          , Gs          , Gg          , Gg          , Gg          , Ce          , Ce          , Gg          , Ce          , Gg          , Ce          , Gg          , Ce          , Gg          , Ce          , Gg          , Ce          , Gg          , Gg          , Rr          , Gg          , Gg          , Ce          , Gg          , Ce          , Ce          , Ce          , Ce          , Ce          , Ce          , Gg          , Gg          , Gg          , Gg          , Gs          , Gs          
Gs          , Gg          , Gs          , Gs          , Gs          , Gg          , Gs          , Gg          , Gg          , Ce          , Gg          , Ce          , Gg          , Ce          , Gg          , Ce          , Gg          , Ce          , Gg          , Ce          , Gg          , Rr          , Gg          , Ce          , Gg          , Ce          , Gg          , Gg          , Gg          , Gg          , Gg          , Gg          , Gg          , Gg          , Gg          , Gg          , Gs          , Gs          
Gg          , Gs          , Gs          , Ggf         , Ggf         , Gs          , Gs          , Gg          , Gs          , Gg          , Gg          , Gg          , Gg          , Gg          , Gs          , Gg          , Gg          , Gg          , Gg          , Gg          , Gg          , Rr          , Gg          , Gg          , Ggf         , Gg          , Gs          , Gg          , Gs          , Gg          , Ggf         , Gg          , Gg          , Gg          , Gg          , Gs          , Gs          , Gs          
Gg          , Gg          , Gs          , Gs          , Gs          , Gs          , Ggf         , Gs          , Gs          , Gg          , Ggf         , Gg          , Ggf         , Gs          , Gg          , Gs          , Gs          , Gg          , Gg          , Gg          , Rr          , Rr          , Gg          , Gg          , Gs          , Gs          , Ggf         , Gs          , Gs          , Gs          , Gs          , Gs          , Gs          , Gs          , Gs          , Gs          , Gs          , Gg          
Gg          , Gg          , Gs          , Gg          , Gg          , Gs          , Gg          , Gg          , Gg          , Gs          , Gs          , Gs          , Gs          , Gs          , Gs          , Gg          , Gs          , Ggf         , Gs          , Gg          , Rr          , Gg          , Ggf         , Gs          , Gg          , Ggf         , Gg          , Gs          , Gs          , Gs          , Gs          , Gg          , Gg          , Gg          , Gg          , Gs          , Gs          , Gg          
Gg          , Gg          , Gg          , Gs          , Gs          , Gs          , Gs          , Gs          , Gs          , Gs          , Gg          , Gs          , Gg          , Gg          , Gs          , Gs          , Gs          , Gs          , Gs          , Gg          , Rr          , Gg          , Gg          , Gs          , Gs          , Gs          , Gg          , Gs          , Gs          , Gs          , Gs          , Gs          , Gg          , Gg          , Gg          , Gs          , Gs          , Gs          
Gg          , Gg          , Gg          , Ggf         , Gg          , Gs          , Gg          , Gs          , Gg          , Gg          , Gg          , Gg          , Gg          , Gg          , Gg          , Ggf         , Gg          , Gs          , Gg          , Gs          , Rr          , Gg          , Gg          , Gg          , Gg          , Gg          , Gg          , Gg          , Gg          , Gs          , Gg          , Gg          , Gg          , Gg          , Gg          , Gs          , Gg          , Gs          
