border_size=1
usage=map

Gs^Fds      , Gs^Fds      , Gg          , Gs          , Gs          , Gg          , Gs          , Gs^Fds      , Gg          , Gg          , Gg          , Rr          , Gg          , Gg          , Gg          , Gg          , Gg          , Gg          , Gs^Fds      , Gg          , Gg          , Gg          , Gs^Fds      , Gg          , Gg          , Gg          , Gg          , Gg          , Gs^Fds      , Gs^Fds      , Gg          , Gg          , Gs          , Gs          
Gs^Fds      , Gs^Fds      , Gg          , Gg          , Gg          , Gs          , Gg          , Gs^Fds      , Gs          , Gg          , Gg          , Rr          , Gg          , Gg          , Gg          , Gs          , Gg          , Gg          , Gs^Fds      , Gg          , Gg          , Gg          , Gs^Fds      , Gg          , Gg          , Gg          , Gg          , Gg          , Gs^Fds      , Gs^Fds      , Gg          , Gs          , Gs          , Gs          
Gg          , Gs          , Gg          , Gs^Fds      , Gs^Fds      , Gs^Fds      , Gg          , Gs^Fds      , Gg          , Gg          , Ce          , Ce          , Ce          , Gg          , Gg          , Gs^Fds      , Gg          , Gg          , Gs^Fds      , Gs^Fds      , Gg          , Gg          , Gs^Fds      , Gs          , Gg          , Gs^Fds      , Gg          , Gs^Fds      , Gs          , Gg          , Gg          , Gs^Fds      , Gs^Fds      , Gs^Fds      
Gg          , Gg          , Gs^Fds      , Gs^Fds      , Gs^Fds      , Gg          , Gg          , Gs^Fds      , Gs          , Gg          , Gg          , 1 Ke        , Ce          , Gg          , Gg          , Gs^Fds      , Gg          , Gg          , Gs^Fds      , Gs^Fds      , Gs^Fds      , Gg          , Gg          , Gs^Fds      , Gs^Fds      , Gs^Fds      , Gg          , Gg          , Gs^Fds      , Gs          , Gg          , Gg          , Gs^Fds      , Gs^Fds      
Gs^Fds      , Gs^Fds      , Gg          , Gs^Fds      , Gs          , Gg          , Gs^Fds      , Gs          , Gg          , Gg          , Gg          , Ce          , Ce          , Gg          , Gg          , Gs^Fds      , Gg          , Gs          , Gg          , Gg          , Gg          , Gg          , Gg          , Gg          , Gs^Fds      , Gs          , Gg          , Gs^Fds      , Gs^Fds      , Gg          , Gs^Fds      , Gg          , Gs^Fds      , Gs^Fds      
Gg          , Gs          , Gg          , Gg          , Gs^Fds      , Gg          , Gg          , Gs^Fds      , Gs          , Gg          , Gg          , Rr          , Gs          , Gg          , Gg          , Gs^Fds      , Gg          , Gg          , Gg          , Hh          , Gs          , Gg          , Gs          , Gg          , Gs          , Gs          , Gg          , Gs^Fds      , Gg          , Gs^Fds      , Gs^Fds      , Gs          , Gs^Fds      , Gs^Fds      
Gs          , Gg          , Gg          , Gs^Fds      , Gs^Fds      , Gs^Fds      , Gg          , Gs^Fds      , Gs          , Gg          , Gg          , Rr          , Gg          , Gg          , Gg          , Gg          , Gg          , Gg          , Hh          , Hh          , Hh          , Gg          , Gg          , Gg          , Gs          , Gg          , Gg          , Gg          , Gg          , Gg          , Gg          , Gg          , Gg          , Gg          
Gg          , Gg          , Gs          , Gs^Fds      , Gg          , Gg          , Gs          , Gs^Fds      , Gg          , Gg          , Gg          , Rr          , Gg          , Gs          , Gg          , Gs          , Gg          , Hh          , Hh          , Hh          , Hh          , Gg          , Gg          , Gg          , Gg          , Gg          , Gg          , Gs          , Gg          , Gs^Fds      , Gs^Fds      , Gg          , Gg          , Gg          
Gg          , Gg          , Gs^Fds      , Gg          , Gg          , Gg          , Gg          , Gg          , Gs          , Gg          , Hh          , Rr          , Gg          , Gg          , Gg          , Gg          , Gg          , Hh          , Gg          , Gg          , Gg          , Gg          , Gg          , Gg          , Hh          , Gg          , Gg          , Gs^Fds      , Gs^Fds      , Gs^Fds      , Gg          , Gg          , Gg          , Gg          
Gg          , Gg          , Gs^Fds      , Gs^Fds      , Gg          , Gg          , Gg          , Gg          , Gg          , Hh          , Hh          , Rr          , Hh          , Hh          , Gg          , Gg          , Gg          , Gg          , Gs          , Gg          , Gs^Fds      , Gg          , Hh          , Hh          , Hh          , Gs          , Gg          , Gg          , Gg          , Gs^Fds      , Gg          , Gg          , Gg          , Gg          
Gg          , Gg          , Gs^Fds      , Gs^Fds      , Gg          , Gg          , Gg          , Gg          , Gg          , Gg          , Hh          , Rr          , Hh          , Gg          , Gg          , Gg          , Gg          , Gg          , Gs^Fds      , Gs^Fds      , Gs^Fds      , Gg          , Hh          , Hh          , Gg          , Gg          , Gg          , Gg          , Gs          , Gg          , Gg          , Gg          , Gg          , Gg          
Gg          , Gg          , Gg          , Gs          , Gg          , Gg          , Gs          , Gg          , Gg          , Gg          , Gg          , Rr          , Gg          , Gs          , Gs          , Gg          , Gg          , Gg          , Gg          , Gg          , Gg          , Hh          , Gg          , Hh          , Hh          , Gg          , Gg          , Gg          , Gg          , Gg          , Gg          , Gg          , Hh          , Hh          
Gg          , Gg          , Gg          , Gg          , Gs          , Gs          , Gg          , Gg          , Gg          , Gs          , Gg          , Rr          , Gg          , Gg          , Gs          , Gg          , Gg          , Gg          , Gs^Fds      , Gg          , Gs^Fds      , Gs^Fds      , Gs          , Gg          , Gg          , Gg          , Gg          , Gs          , Gs          , Gs          , Gs          , Hh          , Hh          , Hh          
Gg          , Gg          , Gs          , Gg          , Gg          , Gg          , Gg          , Gg          , Gg          , Gg          , Gg          , Rr          , Gg          , Gg          , Gg          , Gg          , Gg          , Gs          , Gg          , Gs^Fds      , Gs^Fds      , Gs^Fds      , Gs          , Gg          , Gs^Fds      , Gs^Fds      , Gg          , Gg          , Gg          , Gs          , Gg          , Gg          , Hh          , Hh          
Gg          , Gg          , Gs          , Gg          , Gg          , Gg          , Gg          , Gg          , Gg          , Gg          , Gg          , Rr          , Gg          , Gg          , Gg          , Hh          , Hh          , Gg          , Gg          , Gg          , Gg          , Gs^Fds      , Gs          , Gg          , Gg          , Gg          , Gg          , Gs          , Gg          , Gg          , Gg          , Gs          , Gg          , Gs          
Gs          , Gg          , Gg          , Gg          , Gg          , Gg          , Hh          , Gs          , Gg          , Gg          , Gg          , Rr          , Gg          , Gg          , Hh          , Hh          , Hh          , Gg          , Gg          , Gg          , Gg          , Gg          , Hh          , Gg          , Hh          , Gg          , Gg          , Gs          , Gg          , Gg          , Gg          , Gg          , Gg          , Gg          
Gg          , Gg          , Gg          , Gg          , Gs          , Hh          , Hh          , Hh          , Gg          , Gg          , Gg          , Rr          , Gg          , Gg          , Hh          , Hh          , Hh          , Gs          , Gg          , Gg          , Gg          , Gg          , Gs          , Hh          , Hh          , Gg          , Gg          , Gg          , Gg          , Gg          , Gg          , Gg          , Gg          , Gg          
Gg          , Gg          , Gg          , Gs          , Gg          , Hh          , Hh          , Hh          , Gg          , Gg          , Gg          , Rr          , Gg          , Gg          , Gg          , Gg          , Gg          , Gg          , Gg          , Gg          , Gs          , Gg          , Hh          , Hh          , Hh          , Gg          , Gg          , Gg          , Gg          , Gg          , Gg          , Gg          , Gg          , Gg          
Gs          , Gg          , Gg          , Gg          , Gg          , Gg          , Hh          , Gs          , Gs          , Gg          , Gg          , Rr          , Gg          , Gg          , Gg          , Gs          , Gg          , Gg          , Gg          , Gg          , Gg          , Gg          , Gg          , Gg          , Gg          , Gg          , Gg          , Gg          , Gg          , Gg          , Gg          , Gg          , Gg          , Gg          
Gg          , Gg          , Gg          , Gg          , Gs          , Gg          , Gg          , Gg          , Gs          , Gs          , Gg          , Rr          , Gg          , Gg          , Gg          , Gg          , Gg          , Gs          , Gs          , Gg          , Gg          , Gg          , Gg          , Gg          , Gg          , Gg          , Gg          , Gg          , Ww          , Gg          , Gg          , Gg          , Ww          , Ww          
Gg          , Gg          , Hh          , Hh          , Gs          , Gg          , Gg          , Gs          , Gg          , Gg          , Gg          , Rr          , Hh          , Gg          , Gg          , Gg          , Gg          , Gg          , Gs          , Gs          , Gg          , Gg          , Gg          , Gg          , Gg          , Gg          , Ww          , Ww          , Ww          , Ww          , Ww          , Ww          , Ww          , Ww          
Gg          , Gg          , Hh          , Hh          , Hh          , Gg          , Gg          , Gg          , Gg          , Gg          , Hh          , Rr          , Hh          , Hh          , Gg          , Gg          , Gg          , Gg          , Gg          , Gg          , Gg          , Gg          , Gg          , Gg          , Ww          , Ww          , Wo          , Ww          , Ww          , Wo          , Wo          , Wo          , Ww          , Ww          
Hh          , Hh          , Gs          , Hh          , Gg          , Gs          , Gg          , Gg          , Gg          , Gg          , Gg          , Rr          , Hh          , Gg          , Gg          , Gg          , Gg          , Gg          , Gg          , Gg          , Gg          , Gg          , Ww          , Ww          , Wo          , Wo          , Ww          , Ww          , Ww          , Wo          , Ww          , Ww          , Ww          , Ww          
Gg          , Gg          , Gg          , Hh          , Gg          , Gs          , Gg          , Gg          , Gg          , Gg          , Gg          , Rr          , Gg          , Gg          , Gg          , Gg          , Gg          , Gg          , Gg          , Gg          , Dd          , Dd          , Ww          , Ww          , Ww          , Ww          , Dd          , Gg          , Gg          , Ww          , Gg          , Gg          , Gg          , Gg          
Gg          , Gg          , Gg          , Gg          , Gs          , Gg          , Gg          , Gs          , Gs          , Gg          , Gg          , Rr          , Gg          , Gg          , Gg          , Gg          , Gg          , Gg          , Dd          , Dd          , Ww          , Ww          , Wo          , Wo          , Ww          , Ss          , Dd          , Dd          , Gs          , Gg          , Gg          , Gg          , Rr          , Rr          
Gg          , Gg          , Gg          , Gg          , Gg          , Gg          , Gg          , Gg          , Gg          , Gg          , Gg          , Rr          , Gg          , Gg          , Dd          , Gg          , Dd          , Dd          , Ww          , Ww          , Wo          , Wo          , Ww          , Ww          , Ss          , Ss          , Ss          , Dd          , Dd          , Gg          , Rr          , Rr          , Gg          , Gg          
Rr          , Gg          , Gg          , Gg          , Gg          , Gg          , Gs          , Gg          , Gg          , Gg          , Dd          , Rr          , Dd          , Dd          , Ss          , Dd          , Ww          , Ww          , Wo          , Ww          , Ww          , Ww          , Gg^Vh       , Ss          , Gg^Vh       , Ch          , Ch          , Ss          , Rr          , Rr          , Dd          , Gg          , Gs          , Gg          
Gg          , Rr          , Rr          , Gg          , Gg          , Gs          , Gs          , Gg          , Gg          , Dd          , Dd          , Rr          , Ss          , Ss          , Ch          , Ss          , Ww          , Ww          , Ww          , Ww          , Gg          , Gg^Vh       , Gg^Vh       , Gg^Vh       , Gg^Vh       , Gg^Vh       , Rr          , Kh          , Ss          , Dd          , Dd          , Gs          , Gs          , Gs          
Gg          , Gg          , Gg          , Rr          , Rr          , Gg          , Gg          , Gg          , Dd          , Dd          , Ss          , Rr          , Ch          , Ch          , Rr          , Ch          , Ww          , Wo          , Ww          , Ww          , Gg^Vh       , Gg^Vh       , Gg^Vh       , Gg^Vh       , Rr          , Rr          , Gg^Vh       , Ch          , Ss          , Dd          , Dd          , Gs          , Gg          , Gg          
Gg          , Gg          , Gg          , Gg          , Gg          , Rr          , Rr          , Dd          , Ss          , Ss          , Ch          , Ch          , Rr          , Rr          , Kh          , Rr          , Ww          , Wo          , Ww          , Gg^Vh       , Rr          , Rr          , Rr          , Hh^Vhh      , Rr          , Gg^Vh       , Gg^Vh       , Ch          , Ss          , Dd          , Dd          , Gs          , Gg          , Gg          
Gg          , Gg          , Gs          , Gg          , Gg          , Dd          , Dd          , Rr          , Ch          , Ch          , Rr          , Rr          , Kh          , Kh          , Gg^Vh       , Kh          , Ww          , Ww          , Ww^Bw/      , Rr          , Gg^Vh       , Hh^Vhh      , Gg^Vh       , Rr          , Rr          , Gg^Vh       , Gg^Vh       , Ch          , Ss          , Dd          , Dd          , Gs          , Gg          , Gg          
Gg          , Gs          , Gs          , Gg          , Gg          , Gg          , Dd          , Ss          , Ch          , Rr          , Kh          , Kh          , Rr          , Gg^Vh       , Hh^Vhh      , Gg^Vh       , Rr          , Ww^Bw/      , Ww          , Ww          , Gg^Vh       , Gg^Vh       , Gg^Vh       , Gg^Vh       , Gg^Vh       , Rr          , Gg^Vh       , Ch          , Ss          , Dd          , Gs          , Gs          , Gg          , Gs          
Gs          , Gs          , Gg          , Gg          , Gg          , Dd          , Dd          , Ss          , Ch          , Rr          , Kh          , Gg^Vh       , Gg^Vh       , Rr          , Rr          , Rr          , Gg^Vh       , Ww          , Wo          , Ww          , Ww          , Gg^Vh       , Gg^Vh       , Hh^Vhh      , Gg^Vh       , Rr          , Gg^Vh       , Ch          , Ss          , Dd          , Gg          , Gg          , Gg          , Gg          
Gg          , Gg          , Gs          , Gg          , Gg          , Dd          , Ww          , Ss          , Ch          , Rr          , Kh          , Gg^Vh       , Hh^Vhh      , Gg^Vh       , Rr          , Hh^Vhh      , Ww          , Ww          , Wo          , Ww          , Gg^Vh       , Gg^Vh       , Gg          , Gg^Vh       , Gg^Vh       , Rr          , Gg^Vh       , Ch          , Ss          , Dd          , Gs          , Gs          , Gs          , Gg          
Gg          , Gg          , Gg          , Gg          , Ww          , Ww          , Ww          , Ww          , Ww          , Rr          , Ww          , Gg^Vh       , Gg^Vh       , Gg^Vh       , Gg^Vh       , Rr          , Ww^Bw\      , Ww          , Ww          , Ww          , Kh          , Gg^Vh       , Gg^Vh       , Gg^Vh       , Hh^Vhh      , Rr          , Gg^Vh       , Ch          , Ss          , Dd          , Gs          , Gg          , Gs          , Gg          
Gg          , Gg          , Ww          , Ww          , Wo          , Wo          , Wo          , Wo          , Ww          , Ww          , Ww          , Ww          , Ww          , Ww          , Ww          , Ww          , Ww          , Ww^Bw\      , Rr          , Gg          , Gg^Ve       , Kh          , Kh          , Gg^Vh       , Gg^Vh       , Rr          , Gg^Vh       , Ch          , Ss          , Dd          , Gs          , Gg          , Gg          , Gg          
Ww          , Ww          , Wo          , Wo          , Ww          , Ww          , Ww          , Ww          , Ww          , Wo          , Wo          , Wo          , Wo          , Wo          , Ww          , Ww          , Ww          , Ww          , Gg          , Rr          , 2 Rr        , Gg^Ve       , Gg^Ve       , Kh          , Gg^Vh       , Rr          , Gg^Vh       , Ch          , Ss          , Dd          , Gs          , Gg          , Gg          , Gg          
Ww          , Ww          , Ww          , Ww          , Gs          , Dd          , Dd          , Ss          , Ch          , Ww          , Ww          , Ww          , Ww          , Ww          , Gg^Vh       , Ww          , Kh          , Gg^Ve       , Gg^Ve       , Rr          , Rr          , Rr          , Gg^Ve       , Kh          , Gg^Vh       , Rr          , Gg^Vh       , Ch          , Ss          , Dd          , Dd          , Gg          , Gg          , Gg          
Ww          , Ww          , Gg          , Gg          , Gs          , Dd          , Dd          , Ss          , Ch          , Gg^Vh       , Gg^Vh       , Gg          , Gg^Vh       , Gg^Vh       , Hh^Vhh      , Gg^Vh       , Gg^Vh       , Kh          , Kh          , Gg^Ve       , Gg^Ve       , Gg^Ve       , Kh          , Kh          , Gg^Vh       , Rr          , Gg^Vh       , Ch          , Ss          , Dd          , Gs          , Gg          , Gg          , Gg          
Gg          , Gg          , Gg          , Gg          , Gs          , Dd          , Dd          , Ss          , Ch          , Gg^Vh       , Rr          , Hh^Vhh      , Rr          , Gg          , Gg^Vh       , Gg^Vh       , Gg^Vh       , Gg^Vh       , Gg^Vh       , Kh          , Kh          , Kh          , Gg^Vh       , Gg^Vh       , Rr          , Rr          , Rr          , Ch          , Ss          , Dd          , Gs          , Gg          , Gg          , Gg          
Gg          , Gg          , Gg          , Gs          , Gg          , Dd          , Dd          , Ss          , Kh          , Rr          , Gg^Vh       , Rr          , Gg^Vh       , Rr          , Rr          , Gg^Vh       , Hh^Vhh      , Gg^Vh       , Hh^Vhh      , Gg^Vh       , Gg^Vh       , Gg^Vh       , Rr          , Rr          , Gg^Vh       , Gg^Vh       , Ch          , Kh          , Rr          , Dd          , Gg          , Gg          , Gg          , Gg          
Gg          , Gs          , Gs          , Hh          , Hh          , Gg          , Rr          , Rr          , Ss          , Ch          , Ch          , Gg^Vh       , Gg^Vh       , Gg^Vh       , Gg^Vh       , Rr          , Rr          , Rr          , Rr          , Rr          , Rr          , Rr          , Gg^Vh       , Gg^Vh       , Ch          , Ch          , Ss          , Ss          , Dd          , Rr          , Rr          , Gg          , Gg          , Gg          
Gg          , Gg          , Hh          , Hh          , Rr          , Rr          , Gg          , Dd          , Dd          , Ss          , Ss          , Ch          , Ch          , Gg^Vh       , Gg^Vh       , Gg^Vh       , Rr          , Gg^Vh       , Gg^Vh       , Gg^Vh       , Gg^Vh       , Gg^Vh       , Ch          , Ch          , Ss          , Ss          , Dd          , Dd          , Dd          , Gg          , Gg          , Rr          , Rr          , Gg          
Gg          , Gg          , Rr          , Rr          , Gs          , Hh          , Gg          , Dd          , Gs          , Dd          , Dd          , Ss          , Ss          , Ch          , Ch          , Ch          , Kh          , Ch          , Ch          , Ch          , Ch          , Ch          , Ss          , Ss          , Dd          , Dd          , Gs          , Gs          , Gs          , Gg          , Gg          , Gg          , Gs          , Rr          
Rr          , Rr          , Gg          , Gg          , Gs          , Gg          , Gg          , Gg          , Gg          , Gs          , Gs          , Dd          , Dd          , Ss          , Ss          , Ss          , Rr          , Ss          , Ss          , Ss          , Ss          , Ss          , Dd          , Dd          , Dd          , Dd          , Gs          , Gg          , Gg          , Gg          , Gg          , Gg          , Gg          , Gg          
Gs          , Gg          , Gg          , Gg          , Gg          , Gg          , Gg          , Gg          , Gg          , Gs          , Gs          , Gs          , Gs          , Dd          , Dd          , Dd          , Rr          , Dd          , Dd          , Dd          , Dd          , Dd          , Gs          , Dd          , Gs          , Gs          , Gg          , Gs          , Gg          , Gg          , Gg          , Gg          , Gs          , Gg          
Gg          , Gg          , Gg          , Gg          , Gs          , Gg          , Gs          , Gg          , Gg          , Gg          , Gg          , Gs          , Gg          , Gs          , Gg          , Gg          , Rr          , Gg          , Gg          , Gs          , Gs          , Gs          , Gg          , Gg          , Gg          , Gg          , Gs          , Gg          , Gg          , Gs          , Gg          , Gg          , Gg          , Gg          
Gg          , Gg          , Gg          , Gg          , Gg          , Gg          , Gg          , Gg          , Gg          , Gg          , Gs          , Gg          , Gg          , Gs          , Gg          , Gg          , Rr          , Gg          , Gg          , Gs          , Gg          , Gg          , Gg          , Gg          , Gg          , Gg          , Gg          , Gg          , Gg          , Gg          , Gg          , Gg          , Gg          , Gg          
