border_size=1
usage=map

Gg          , Rd          , Gg          , Gs^Fmf      , Gs^Fmf      , Gs^Fp       , Gs^Fmf      , Gs^Fp       , Hh          , Hh          , Mm          , Hh          , Hh          , Hh          , Hh          , Wo          , Wo          , Hh          , Hh          , Mm          , Mm          , Mm          
Gg          , Rd          , Rd          , Gs^Fmf      , Gs^Fp       , Gs^Fp       , Gs^Fp       , Gs^Fp       , Hh          , Hh          , Mm          , Hh          , Hh          , Hh          , Hh          , Wo          , Wo          , Hh          , Hh          , Mm          , Mm          , Mm          
Gg          , Gg          , Rd          , Gs^Fp       , Gg          , Gs^Fp       , Gs^Fp       , Gs^Fp       , Hh          , Mm          , Mm          , Mm          , Hh          , Hh          , Wo          , Wo          , Wo          , Wo          , Hh          , Mm          , Mm          , Mm          
Gg          , Gg          , Rd          , Gg          , Gg          , Gg          , Gg          , Gg          , Hh          , Mm          , Mm          , Mm          , Mm          , Hh          , Wo          , Wo          , Wo          , Wo          , Hh          , Mm          , Mm          , Mm          
Hh          , Hh^Vhh      , Rd          , Hh          , Gg          , Gg          , Gs^Fp       , Gg          , Hh          , Mm          , Mm          , Mm          , Hh          , Hh          , Wo          , Wo          , Hh          , Wo          , Hh          , Mm          , Mm          , Mm          
Gg          , Gg          , Rd          , Hh          , Hh          , Hh          , Gg          , Gg          , Hh          , Mm          , Hh          , Hh          , Gg          , Hh          , Hh          , Hh          , Mm          , Hh          , Hh          , Mm          , Mm          , Mm          
Gg          , Gg          , Gg          , Rd          , Rd          , Gg^Vh       , Gg          , Mm          , Gg          , Hh          , Gg          , Gg          , Gs^Fp       , Hh          , Hh          , Mm          , Mm          , Mm          , Mm          , Mm          , Mm^Xm       , Mm^Xm       
Hh          , Hh          , Hh          , Hh          , Gg          , Rd          , Rd          , Gg          , Gg          , Gs^Fp       , Gs^Fp       , Gs^Fp       , Gg^Vh       , Hh          , Mm          , Mm          , Mm          , Mm          , Mm          , Mm^Xm       , Mm          , Mm          
Hh          , Hh          , Hh          , Hh          , Hh          , Hh          , Hh          , Rd          , Hh          , Gg          , Gg          , Gg          , Gg          , Hh          , Hh          , Mm          , Mm          , Mm          , Mm          , Mm^Xm       , Mm^Xm       , Mm^Xm       
Mm          , Mm          , Hh          , Mm          , Hh          , Mm          , Hh          , Rd          , Ce          , Gg          , Hh          , Hh          , Hh          , Hh          , Mm          , Mm          , Mm          , Mm^Xm       , Mm^Xm       , Mm^Xm       , Mm          , Mm          
Mm          , Mm          , Mm          , Hh          , Hh          , Mm          , Hh          , Ce          , Ce          , Hh          , Mm          , Mm          , Mm          , Hh          , Mm          , Mm          , Mm^Xm       , Mm^Xm       , Mm^Xm       , Mm^Xm       , Mm          , Mm          
Mm          , Mm          , Mm^Xm       , Mm          , Mm          , Mm          , Mm          , Hh          , Rr          , Hh          , Mm          , Mm          , Mm          , Mm^Vhh      , Mm          , Mm          , Mm^Xm       , Mm^Xm       , Mm          , Mm^Xm       , Mm          , Mm          
Mm^Xm       , Mm^Xm       , Mm          , Mm          , Mm          , Mm          , Mm          , Mm          , Hh          , Rr          , Hh          , Mm          , Mm          , Mm          , Mm          , Mm          , Mm          , Mm          , Mm^Xm       , Mm^Xm       , Mm          , Mm          
Mm          , Mm          , Mm          , Mm          , Mm          , Mm          , Mm          , Mm          , Hh          , Rr          , Gg          , Hh          , Mm          , Hh          , Hh          , Hh          , Hh^Vhh      , Mm          , Mm          , Hh          , Mm          , Mm          
Mm          , Mm          , Mm          , Hh          , Hh          , Hh          , Hh          , Hh          , Hh          , Rr          , Rr          , Hh          , Hh          , Hh          , Gg          , Hh          , Hh          , Mm          , Mm          , Mm          , Hh          , Hh          
Hh          , Hh          , Mm          , Hh          , Hh          , Hh          , Hh          , Hh          , Gg          , Gg          , Rr          , Hh          , Hh          , Hh          , Gg          , Hh          , Hh          , Mm          , Mm          , Hh          , Mm          , Mm          
Mm          , Mm          , Hh          , Mm          , Hh          , Mm          , Hh          , Hh          , Gg          , Gg          , Rr          , Gg          , Hh          , Hh          , Hh          , Gg          , Gg          , Hh          , Hh          , Hh          , Mm          , Mm          
Hh          , Hh          , Hh          , Hh          , Hh          , Hh          , Gg          , Hh          , Gg          , Gg          , Rr          , Hh          , Hh          , Hh          , Mm          , Hh          , Gg          , Hh          , Hh          , Hh          , Hh          , Hh          
Mm          , Mm          , Hh          , Gg          , Gg          , Gg          , Hh          , Gg          , Gg          , Gg          , 1 Rr        , Gg          , Hh          , Mm          , Mm          , Hh          , Hh          , Gg          , Gg          , Mm          , Gg          , Gg          
Mm          , Mm          , Hh          , Gg          , Gg          , Gg          , Hh          , Gg          , Gg          , Gg          , Rr          , Gg          , Hh          , Mm          , Mm          , Hh          , Hh          , Hh          , Hh          , Gg          , Hh          , Hh          
Mm          , Mm          , Hh          , Gg          , Gg          , Gg          , Gg          , Gg          , Gg          , Gg          , Gg          , Rr          , Gg          , Hh          , Hh          , Hh          , Mm          , Mm          , Mm          , Hh          , Hh          , Hh          
Mm          , Mm          , Hh          , Gg          , Gg          , Gg          , Gg          , Gg          , Gg          , Gg          , Gg          , Rr          , Gg          , Hh          , Hh          , Hh          , Mm          , Mm          , Mm          , Hh          , Hh          , Hh          
