border_size=1
usage=map

Re          , Re          , Re          , Aa^Fpa      , Aa^Fdw      , Aa^Fpa      , Aa^Fpa      , Aa^Fpa      , Re          , Re          , Aa^Fpa      , Aa^Fpa      , Aa^Fpa      , Aa^Fpa      , Re          , Aa          , Aa          , Aa          , Re          , Aa          , Re          , Aa^Fpa      , Aa^Fpa      , Aa^Fpa      , Aa^Fpa      , Aa^Fpa      , Aa^Fpa      , Re          , Aa          , Aa          , Aa          , Aa          , Re          , Ai          , Ai          , Ai          , Ww          , Ww          
Re          , Re          , Re          , Aa^Fpa      , Aa^Fdw      , Aa^Fdw      , Aa^Fma      , Aa^Fpa      , Re          , Re          , Aa^Fpa      , Aa^Fpa      , Aa^Fpa      , Aa^Fpa      , Re          , Aa          , Aa          , Aa          , Re          , Aa          , Re          , Aa^Fma      , Aa^Fma      , Aa^Fma      , Aa^Fma      , Aa^Fpa      , Aa^Fpa      , Re          , Aa          , Aa          , Aa          , Aa          , Re          , Ai          , Ai          , Ai          , Ww          , Ww          
Aa^Fpa      , Aa^Fpa      , Aa^Fpa      , Re          , Aa^Fpa      , Aa^Fdw      , Aa^Fma      , Aa^Fpa      , Re          , Re          , Aa          , Aa          , Aa^Fpa      , Aa          , Re          , Re          , Re          , Re          , Re          , Re          , Aa^Fpa      , Re          , Re          , Re          , Re          , Aa^Fpa      , Re          , Aa          , Aa          , Aa          , Re          , Re          , Re          , Ww          , Ai          , Ai          , Ww          , Ww          
Aa^Fpa      , Aa^Fdw      , Aa^Fdw      , Aa^Fpa      , Aa^Fma      , Re          , Re          , Re          , Re          , Aa          , Aa          , Aa^Fpa      , Aa          , Re          , Re          , Re          , Aa          , Re          , Re          , Re          , Aa          , Re          , Aa          , Re          , Re          , Aa^Fma      , Re          , Re          , Re          , Re          , Aa^Fpa      , Re          , Aa^Fdw      , Ww          , Ai          , Ai          , Ww          , Ww          
Re          , Re          , Aa^Fdw      , Aa^Fma      , Re          , Aa^Fdw      , Aa^Fdw      , Re          , Aa^Fpa      , Aa          , Re          , Re          , Re          , Aa          , Re          , Aa          , Gg          , Aa^Fpa      , Aa^Fpa      , Re          , Aa          , Aa          , Aa          , Aa          , Aa          , Re          , Aa^Fpa      , Re          , Re          , Re          , Aa^Fpa      , Aa^Fma      , Re          , Aa^Fdw      , Ai          , Ww          , Ai          , Ai          
Re          , Re          , Re          , Aa^Fdw      , Re          , Aa^Fma      , Aa^Fdw      , Aa^Fdw      , Re          , Re          , Aa^Fpa      , Re          , Re          , Re          , Aa          , Aa          , Aa          , Aa^Fpa      , Re          , Aa^Fpa      , Re          , Aa          , Aa^Fpa      , Aa          , Aa          , Aa^Fpa      , Aa          , Aa^Fpa      , Aa^Fma      , Aa^Fma      , Aa^Fdw      , Re          , Re          , Aa^Fma      , Ww          , Ww          , Ai          , Ai          
Re          , Re          , Aa^Fpa      , Aa^Fma      , Re          , Re          , Aa^Fdw      , Re          , Re          , Re          , Aa^Fpa      , Aa^Fpa      , Aa^Fpa      , Aa          , Re          , Re          , Aa^Fma      , Aa^Fma      , Aa^Fma      , Aa^Fpa      , Re          , Re          , Aa          , Aa^Fpa      , Aa^Fpa      , Aa          , Re          , Re          , Aa^Fpa      , Aa^Fma      , Aa^Fdw      , Aa^Fma      , Aa^Fpa      , Aa^Fpa      , Ww          , Ww          , Ai          , Ai          
Aa^Fpa      , Aa^Fpa      , Aa^Fpa      , Aa^Fpa      , Aa^Fpa      , Re          , Aa^Fma      , Aa^Fdw      , Re          , Aa^Fpa      , Re          , Aa^Fpa      , Aa^Fpa      , Re          , Re          , Re          , Aa^Fdw      , Aa^Fma      , Aa^Fpa      , Re          , Re          , Aa          , Re          , Re          , Re          , Aa^Fpa      , Aa^Fpa      , Aa          , Re          , Re          , Aa^Fpa      , Aa^Fma      , Aa^Fpa      , Re          , Re          , Ww          , Ww          , Ww          
Re          , Re          , Re          , Re          , Aa^Fpa      , Re          , Aa^Fpa      , Aa^Fma      , Aa^Fpa      , Re          , Re          , Re          , Aa^Fpa      , Aa^Fpa      , Re          , Aa^Fma      , Aa^Fdw      , Aa^Fma      , Aa^Fdw      , Re          , Re          , Aa          , Re          , Re          , Re          , Re          , Re          , Aa^Fpa      , Aa^Fpa      , Re          , Aa^Fpa      , Aa          , Re          , Re          , Re          , Ai          , Ai          , Ai          
Aa^Fpa      , Aa^Fpa      , Aa^Fpa      , Re          , Re          , Aa^Fpa      , Aa^Fpa      , Re          , Aa^Fpa      , Re          , Aa^Fpa      , Aa^Fpa      , Aa^Fpa      , Re          , Aa^Fpa      , Aa^Fma      , Re          , Aa^Fma      , Aa^Fma      , Aa^Fma      , Aa^Fma      , Aa^Fpa      , Aa^Fpa      , Aa^Fpa      , Re          , Re          , Aa          , Aa          , Aa^Fpa      , Aa^Fpa      , Aa^Fpa      , Re          , Aa          , Re          , Re          , Ai          , Ai          , Ai          
Aa^Fpa      , Aa^Fpa      , Aa^Fpa      , Re          , Re          , Aa^Fpa      , Re          , Re          , Aa^Fpa      , Re          , Re          , Aa^Fpa      , Re          , Re          , Re          , Re          , Aa^Fma      , Aa^Fpa      , Aa^Fma      , Re          , Re          , Re          , Aa^Fpa      , Re          , Re          , Aa          , Re          , Aa^Fpa      , Re          , Re          , Re          , Re          , Re          , Re          , Re          , Ai          , Ww          , Ww          
Re          , Re          , Aa          , Re          , Aa^Fpa      , Re          , Aa^Fdw      , Re          , Aa          , Aa^Fpa      , Aa^Fdw      , Re          , Aa^Fdw      , Re          , Re          , Re          , Aa^Fma      , Re          , Aa^Fma      , Aa^Fma      , Aa^Fma      , Aa^Fpa      , Re          , Re          , Re          , Re          , Re          , Re          , Ds          , Re          , Ds          , Re          , Ds          , Re          , Ds          , Ai          , Ww          , Ww          
Aa^Fpa      , Aa^Fpa      , Aa          , Aa^Fpa      , Aa^Fpa      , Aa^Fma      , Aa^Fdw      , Aa^Fma      , Aa          , Aa^Fpa      , Aa^Fma      , Aa^Fma      , Aa^Fdw      , Aa^Fma      , Re          , Aa^Fma      , Aa^Fma      , Aa^Fdw      , Aa^Fdw      , Aa^Fma      , Re          , Ha          , Re          , Aa^Fpa      , Aa^Vha      , Aa          , Re          , Rd          , Ds          , Ds          , Ds          , Ce          , Ce          , Ds          , Ds          , Ai          , Ai          , Ai          
Aa          , Aa          , Aa^Fpa      , Re          , Aa^Fpa      , Aa^Fma      , Aa^Fma      , Aa^Fdw      , Aa^Fpa      , Aa^Fpa      , Ha^Vhha     , Aa^Fdw      , Aa^Fdw      , Aa^Fma      , Aa^Fpa      , Aa          , Aa          , Aa          , Aa          , Ha          , Ha          , Ha          , Re          , Aa          , Rd          , Re          , Re          , Rd          , Ds          , Ce          , Rr          , Gg          , Rr          , Ce          , Ai          , Ai          , Wo          , Wo          
Aa          , Aa          , Aa^Fpa      , Aa^Fpa      , Aa^Fpa      , Re          , Aa^Fma      , Aa^Fdw      , Re          , Re          , Ha          , Ha          , Aa^Fma      , Aa^Fpa      , Aa^Fpa      , Re          , Aa          , Aa          , Aa^Fpa      , Aa^Fpa      , Re          , Ha          , Re          , Aa          , Rd          , Rd          , Rd          , Ds          , Rr          , Gg^Vh       , Rr          , Gg          , Rr          , Gg^Vh       , Ai          , Ww          , Wo          , Wo          
Re          , Re          , Aa^Fpa      , Aa^Fpa      , Aa^Fpa      , Aa^Fpa      , Re          , Aa^Fpa      , Aa^Fpa      , Aa^Fpa      , Hh          , Ha          , Aa^Fma      , Re          , Re          , Aa^Fpa      , Aa^Fpa      , Re          , Re          , Aa          , Aa          , Aa          , Re          , Re          , Re          , Rd          , Ds          , Ds          , Gg          , Rr          , Rr          , Rr          , Rr          , Gg          , Gg^Vh       , Ai          , Wo          , Wo          
Aa^Fpa      , Aa^Fpa      , Aa^Fpa      , Aa^Fpa      , Aa^Fpa      , Aa^Fpa      , Aa^Fpa      , Aa^Fpa      , Re          , Aa^Fpa      , Aa^Fma      , Aa^Fpa      , Re          , Re          , Aa^Fpa      , Aa^Fpa      , Aa^Fma      , Aa^Fpa      , Aa^Fpa      , Aa          , Re          , Re          , Re          , Rd          , Rd          , Re          , Ds          , Ce          , Gg          , Gg          , Rr          , 1 Rr        , Rr          , Rr          , Rr          , Ai          , Ai          , Wo          
Re          , Re          , Aa^Fma      , Re          , Re          , Aa^Fpa      , Re          , Aa^Fpa      , Aa^Fpa      , Aa^Fma      , Aa^Fpa      , Aa^Fpa      , Aa^Fpa      , Aa^Fpa      , Re          , Re          , Re          , Aa^Fpa      , Re          , Re          , Aa          , Aa          , Re          , Re          , Re          , Rd          , Ds          , Ds          , Gg          , Gg          , Rr          , Rr          , Rr          , Gg          , Gg^Vh       , Ww^Bw\      , Ww^Bw\      , Ww          
Aa^Fpa      , Aa^Fma      , Aa^Fdw      , Aa^Fma      , Aa^Fma      , Aa^Fdw      , Aa^Fpa      , Aa^Fpa      , Aa          , Aa^Fpa      , Re          , Aa^Fpa      , Aa          , Aa          , Aa          , Ha          , Ha          , Ha          , Re          , Re          , Aa          , Aa          , Re          , Re          , Rd          , Rd          , Ds          , Ds          , Rr          , Rr          , Rr          , Gg          , Rr          , Rr          , Ww^Bw\      , Ww          , Rr          , Rr          
Aa^Fpa      , Aa^Fdw      , Re          , Re          , Aa^Fpa      , Aa^Fma      , Re          , Aa          , Aa          , Aa          , Aa^Fpa      , Aa          , Aa          , Aa          , Re          , Hh^Vhh      , Ha          , Ha          , Re          , Re          , Re          , Re          , Re          , Rd          , Rd          , Rd          , Re          , Ds          , Ds          , Gg^Vh       , Rr          , Gg          , Rr          , Gg^Vh       , Ww          , Ww^Bw\      , Rr          , Rr          
Aa^Fpa      , Aa^Fma      , Aa^Fma      , Aa^Fdw      , Aa^Fpa      , Re          , Aa          , Aa          , Aa^Fpa      , Re          , Aa^Fpa      , Aa          , Aa          , Aa^Fpa      , Ha          , Hh          , Re          , Hh          , Re          , Re          , Re          , Re          , Re          , Re          , Re          , Re          , Rd          , Rd          , Ds          , Ce          , Ce          , Gg          , Ce          , Ai          , Ai          , Ww          , Ww          , Ww          
Aa^Fpa      , Aa^Fma      , Aa^Fma      , Aa^Fpa      , Aa^Fpa      , Aa^Fpa      , Aa          , Aa          , Re          , Re          , Aa^Fpa      , Re          , Re          , Re          , Ha          , Ha          , Re          , Re          , Re          , Aa^Fpa      , Re          , Re          , Aa^Vha      , Re          , Re          , Rd          , Rd          , Rd          , Rd          , Ds          , Ds          , Ce          , Ai          , Ai          , Wo          , Wo          , Wo          , Wo          
Re          , Re          , Re          , Re          , Re          , Re          , Re          , Aa          , Re          , Aa^Fpa      , Re          , Re          , Ha          , Ha          , Ha          , Re          , Re          , Re          , Re          , Re          , Re          , Re          , Re          , Re          , Re          , Rd          , Re          , Re          , Re          , Rd          , Rd          , Re          , Ai          , Ww          , Wo          , Wo          , Wo          , Wo          
Re          , Re          , Re          , Aa^Fpa      , Aa^Fpa      , Re          , Aa^Fpa      , Re          , Re          , Re          , Hh          , Ha          , Hh          , Ha          , Re          , Ha          , Re          , Aa^Vha      , Re          , Re          , Re          , Re          , Re          , Re          , Re          , Re          , Re          , Re          , Re          , Rd          , Rd          , Re          , Rd          , Ai          , Ww          , Wo          , Wo          , Wo          
Re          , Re          , Re          , Re          , Re          , Re          , Re          , Aa^Fpa      , Re          , Aa          , Re          , Re          , Aa^Fpa      , Aa^Fpa      , Aa^Fpa      , Re          , Re          , Re          , Re          , Re          , Aa          , Re          , Aa          , Re          , Re          , Aa          , Aa          , Aa          , Aa          , Re          , Re          , Re          , Rd          , Ai          , Ww          , Wo          , Ww          , Ww          
Re          , Re          , Re          , Aa^Fpa      , Re          , Re          , Re          , Re          , Re          , Re          , Re          , Re          , Re          , Re          , Re          , Re          , Aa^Fpa      , Re          , Re          , Aa          , Aa          , Aa          , Aa          , Re          , Hh          , Re          , Re          , Aa          , Re          , Re          , Aa^Vha      , Re          , Ai          , Ai          , Wo          , Wo          , Ai          , Ai          
Aa^Fpa      , Aa^Fpa      , Re          , Re          , Re          , Re          , Hh          , Re          , Aa^Fma      , Re          , Aa^Fpa      , Aa^Fpa      , Re          , Re          , Aa^Fpa      , Re          , Re          , Re          , Aa          , Aa          , Aa          , Aa          , Re          , Hh          , Ha          , Hh          , Aa^Vha      , Re          , Re          , Aa          , Aa          , Re          , Ai          , Ai          , Wo          , Ww          , Ai          , Ai          
Re          , Re          , Aa          , Aa          , Aa          , Hh          , Ha          , Ha          , Aa^Fpa      , Aa^Fma      , Re          , Aa          , Re          , Aa^Fpa      , Re          , Re          , Re          , Re          , Re          , Aa          , Re          , Aa          , Hh          , Ha          , Ha          , Hh          , Re          , Re          , Aa          , Aa          , Ai          , Ai          , Ww          , Wo          , Ai          , Ai          , Aa          , Aa          
Aa          , Aa          , Aa^Fpa      , Aa          , Re          , Ha          , Re          , Re          , Aa^Fpa      , Re          , Aa^Fpa      , Aa          , Re          , Aa^Fpa      , Aa^Fpa      , Re          , Aa^Fpa      , Aa^Fpa      , Aa          , Re          , Aa          , Re          , Aa          , Ha          , Hh          , Re          , Re          , Re          , Aa          , Aa          , Ai          , Ai          , Wo          , Wo          , Ai          , Aa          , Re          , Re          
Aa          , Aa          , Aa          , Aa          , Re          , Aa^Fpa      , Aa^Fpa      , Aa^Fpa      , Aa^Fma      , Re          , Aa^Fpa      , Aa^Fpa      , Aa^Fpa      , Re          , Aa          , Aa          , Re          , Aa          , Aa          , Re          , Aa          , Re          , Re          , Aa^Fpa      , Re          , Aa^Fpa      , Re          , Re          , Ai          , Ai          , Ww          , Wo          , Wo          , Ww          , Ai          , Re          , Re          , Re          
Aa          , Aa          , Aa          , Aa^Fpa      , Re          , Aa^Fpa      , Aa^Fma      , Re          , Aa^Fdw      , Re          , Aa^Fma      , Re          , Re          , Aa^Fpa      , Aa          , Aa          , Re          , Re          , Aa^Fma      , Aa          , Re          , Aa          , Aa^Fma      , Re          , Aa^Fma      , Re          , Re          , Re          , Wwf         , Ai          , Ww          , Wo          , Ai          , Ai          , Re          , Re          , Re          , Re          
Re          , Re          , Re          , Re          , Re          , Aa^Fpa      , Aa^Fma      , Re          , Aa^Fdw      , Re          , Aa^Fma      , Aa^Fma      , Re          , Aa^Fpa      , Aa          , Aa^Fpa      , Re          , Aa^Fdw      , Aa^Fdw      , Aa^Fma      , Re          , Aa^Vha      , Aa^Fdw      , Re          , Aa^Fdw      , Aa^Fma      , Re          , Re          , Wwf         , Wwf         , Ww          , Ww          , Wwf         , Re          , Re          , Aa^Fpa      , Aa^Fpa      , Aa^Fpa      
Aa^Fpa      , Aa^Fpa      , Re          , Re          , Aa^Fpa      , Ha          , Ha          , Aa^Fdw      , Aa^Fma      , Aa^Fma      , Aa^Fma      , Re          , Re          , Re          , Aa^Fpa      , Re          , Ha          , Ha          , Re          , Aa^Fpa      , Re          , Aa^Fdw      , Re          , Aa^Fdw      , Re          , Re          , Aa          , Aa          , Ai          , Wwf         , Ww          , Ww          , Wwf         , Re          , Re          , Aa^Fpa      , Aa^Fpa      , Aa^Fpa      
Re          , Re          , Re          , Re          , Hh          , Ha          , Re          , Aa^Fdw      , Aa^Fma      , Re          , Re          , Aa^Fpa      , Aa^Fma      , Re          , Aa^Fpa      , Hh          , Ha          , Ha          , Aa^Fpa      , Re          , Aa^Fpa      , Re          , Aa^Fma      , Aa^Fma      , Aa^Fma      , Re          , Re          , Aa          , Re          , Ww          , Wo          , Wwf         , Wwf         , Re          , Aa^Fpa      , Aa^Fpa      , Re          , Re          
Re          , Re          , Aa^Fdw      , Re          , Re          , Hh          , Re          , Aa^Fma      , Re          , Re          , Aa^Fma      , Re          , Aa^Fdw      , Aa^Fpa      , Aa^Fma      , Re          , Ha          , Hh          , Re          , Re          , Re          , Aa^Fpa      , Re          , Re          , Re          , Re          , Re          , Aa          , Ai          , Ai          , Wo          , Ww          , Ai          , Re          , Aa^Fpa      , Aa^Fpa      , Re          , Re          
Re          , Re          , Aa^Fdw      , Aa^Fdw      , Aa^Fma      , Re          , Aa^Fdw      , Re          , Re          , Aa^Fpa      , Re          , Aa^Fma      , Re          , Aa^Fdw      , Aa^Vha      , Aa          , Re          , Re          , Aa^Fma      , Re          , Aa^Fpa      , Re          , Re          , Aa^Fpa      , Aa^Fpa      , Re          , Wwf         , Re          , Ai          , Ww          , Wo          , Ww          , Ai          , Re          , Re          , Re          , Re          , Re          
Re          , Re          , Re          , Aa^Fma      , Aa^Fma      , Aa^Fma      , Aa^Fdw      , Re          , Re          , Aa^Fpa      , Re          , Aa^Fdw      , Aa^Fma      , Aa^Fma      , Re          , Re          , Aa^Fdw      , Aa^Fma      , Aa^Fdw      , Aa^Fpa      , Re          , Re          , Re          , Re          , Re          , Wwf         , Ww          , Ww          , Wo          , Wo          , Ai          , Ai          , Ai          , Re          , Re          , Re          , Aa          , Aa          
Re          , Re          , Re          , Aa^Fdw      , Re          , Aa^Fma      , Aa^Fdw      , Re          , Aa^Fma      , Re          , Ha          , Aa^Fpa      , Re          , Re          , Aa          , Aa          , Aa^Fma      , Aa^Fdw      , Aa          , Re          , Aa          , Re          , Wwf         , Ai          , Ai          , Ww          , Wo          , Wo          , Ai          , Ai          , Ai          , Ai          , Re          , Re          , Re          , Re          , Aa          , Aa          
Re          , Re          , Re          , Aa^Fdw      , Re          , Re          , Re          , Aa^Fma      , Re          , Hh          , Ha          , Hh          , Re          , Re          , Re          , Aa^Fma      , Aa^Fma      , Re          , Aa          , Aa          , Wwf         , Wwf         , Ww          , Ai          , Wo          , Wo          , Ai          , Ai          , Re          , Re          , Re          , Re          , Re          , Aa^Fpa      , Re          , Aa          , Aa          , Aa          
Re          , Re          , Re          , Aa^Fma      , Aa^Fma      , Re          , Aa^Fma      , Re          , Re          , Hh          , Re          , Re          , Aa^Fpa      , Re          , Aa^Fma      , Aa^Fma      , Aa          , Aa          , Re          , Re          , Wwf         , Ww          , Wo          , Wo          , Wo          , Ww          , Ai          , Re          , Aa^Fma      , Re          , Re          , Re          , Re          , Re          , Re          , Re          , Re          , Re          
Re          , Re          , Re          , Re          , Re          , Re          , Aa^Fpa      , Re          , Re          , Re          , Aa^Fma      , Aa^Fma      , Aa^Fpa      , Aa^Fpa      , Aa^Fpa      , Aa          , Aa          , Re          , Re          , Ai          , Ai          , Ai          , Wo          , Wo          , Ai          , Ai          , Re          , Re          , Re          , Re          , Re          , Re          , Aa^Fdw      , Re          , Re          , Re          , Re          , Re          
Re          , Re          , Re          , Aa^Fpa      , Re          , Re          , Aa^Fpa      , Re          , Re          , Re          , Aa^Fpa      , Aa^Fma      , Hh          , Hh          , Hh          , Re          , Re          , Re          , Ai          , Ai          , Wo          , Wo          , Ww          , Ai          , Ai          , Ai          , Re          , Re          , Re          , Re          , Aa^Fma      , Re          , Re          , Re          , Re          , Aa          , Re          , Re          
Re          , Re          , Re          , Re          , Re          , Re          , Re          , Re          , Re          , Re          , Hh          , Hh          , Hh          , Re          , Re          , Re          , Ai          , Ai          , Wo          , Wo          , Wo          , Ww          , Ai          , Ai          , Re          , Re          , Re          , Re          , Re          , Re          , Re          , Re          , Re          , Re          , Re          , Re          , Re          , Re          
Re          , Re          , Re          , Aa^Fpa      , Re          , Re          , Re          , Re          , Re          , Re          , Re          , Hh          , Ai          , Re          , Ai          , Ai          , Ai          , Wo          , Wo          , Ai          , Ai          , Ai          , Re          , Re          , Re          , Re          , Re          , Re          , Re          , Aa^Fdw      , Re          , Re          , Re          , Re          , Re          , Re          , Aa          , Aa          
Re          , Re          , Aa^Fdw      , Re          , Aa^Fdw      , Re          , Re          , Re          , Ai          , Re          , Ai          , Ai          , Ai          , Ai          , Ai          , Ai          , Wo          , Wo          , Ai          , Ai          , Re          , Re          , Aa          , Re          , Re          , Aa^Fpa      , Re          , Re          , Re          , Re          , Ai          , Re          , Re          , Re          , Aa          , Aa          , Aa          , Aa          
Aa^Fpa      , Aa^Fdw      , Aa^Fdw      , Aa^Fdw      , Re          , Ai          , Re          , Ai          , Ai          , Ai          , Ww          , Ai          , Ww          , Ww          , Wo          , Wo          , Wo          , Ww          , Ai          , Ai          , Re          , Aa          , Re          , Re          , Re          , Re          , Re          , Re          , Re          , Ai          , Wwf         , Re          , Re          , Re          , Re          , Re          , Re          , Re          
Aa^Fpa      , Aa^Fpa      , Re          , Re          , Ai          , Ai          , Ai          , Ai          , Ww          , Ww          , Ww          , Ww          , Wo          , Wo          , Wo          , Wo          , Ai          , Ai          , Re          , Re          , Aa          , Aa          , Re          , Re          , Re          , Aa          , Aa          , Re          , Re          , Aa^Vha      , Re          , Ai          , Re          , Re          , Aa          , Aa          , Re          , Re          
Aa^Fpa      , Aa^Fpa      , Re          , Re          , Ai          , Ai          , Ai          , Ai          , Ww          , Ww          , Ww          , Ww          , Wo          , Wo          , Wo          , Ww          , Ai          , Re          , Re          , Re          , Aa          , Re          , Re          , Re          , Aa          , Aa          , Re          , Re          , Re          , Re          , Re          , Re          , Aa          , Aa          , Re          , Aa          , Re          , Re          
Aa^Fpa      , Aa^Fpa      , Re          , Re          , Ai          , Ai          , Ai          , Ai          , Ww          , Ww          , Ww          , Ww          , Wo          , Wo          , Wo          , Ww          , Ai          , Re          , Re          , Re          , Aa          , Re          , Re          , Re          , Aa          , Aa          , Re          , Re          , Re          , Re          , Re          , Re          , Aa          , Aa          , Re          , Aa          , Re          , Re          
