border_size=1
usage=map

Wo          ,Wo          , Wo          , Wo          , Wo          , Ai          , Ai          , Ai          , Ai          , Ai          , Ai          , Ai          , Wo          , Wo          , Wo          , Wo          , Wo          , Wo          , Wo          , Wo          , Wo          , Ai          , Wo          , Wo          , Wo          , Wo          , Ww          , Wo          , Ww          , Wo          , Wo          , Wo          , Wo          , Wo          , Wo          , Ww          , Ds          , Ww          , Ds          , Ww          , Ww          , Ww          
Wo          ,Wo          , Wo          , Wo          , Wo          , Ai          , Ai          , Ai          , Ai          , Ai          , Ai          , Ai          , Wo          , Wo          , Wo          , Wo          , Wo          , Wo          , Wo          , Wo          , Wo          , Ai          , Wo          , Wo          , Wo          , Wo          , Ww          , Wo          , Ww          , Wo          , Wo          , Wo          , Wo          , Wo          , Wo          , Ww          , Ds          , Ww          , Ds          , Ww          , Ww          , Ww          
Ai          ,Ai          , Wo          , Wo          , Wo          , Ai          , Wo          , Ai          , Wo          , Wo          , Wo          , Wo          , Wo          , Wo          , Wo          , Wo          , Wo          , Wo          , Wo          , Ai          , Wo          , Wo          , Wo          , Wo          , Wo          , Wo          , Ww          , Ww          , Ds          , Ds          , Ds          , Ww          , Ww          , Ww          , Ww          , Ww          , Ww          , Ds          , Ww          , Ds          , Ww          , Ww          
Ai          ,Ai          , Wo          , Wo          , Wo          , Wo          , Wo          , Wo          , Wo          , Wo          , Wo          , Wo          , Wo          , Wo          , Wo          , Wo          , Wo          , Wo          , Wo          , Wo          , Wo          , Wo          , Wo          , Wo          , Wo          , Wo          , Ds          , Ds          , Ww          , Ds          , Ww          , Ww          , Ds          , Ww          , Wwf         , Ww          , Ds          , Ww          , Ds          , Ds          , Wwf         , Wwf         
Ai          ,Ai          , Ai          , Wo          , Wo          , Wo          , Wo          , Wo          , Ww          , Ai          , Ce          , Ai          , Ai          , Wo          , Wo          , Wo          , Wo          , Wo          , Wo          , Wo          , Wo          , Ww          , Ww          , Ww          , Ww          , Ds          , Ds          , Ds          , Ww          , Ww          , Ww          , Ds          , Wwf         , Wwf         , Wwf         , Wwf         , Wwf         , Wwf         , Wwf         , Ww          , Wwf         , Wwf         
Wo          ,Wo          , Wo          , Wo          , Wo          , Wo          , Wo          , Ww          , 1 Ke        , 3 Ke        , Ce          , Ce          , Ds          , Ai          , Wo          , Wo          , Ww          , Ww          , Ww          , Wo          , Wo          , Wo          , Wo          , Wo          , Ww          , Ds          , Wwf         , Ww          , Wwf         , Ww          , Wwf         , Wwf         , Gg          , Gg          , Gg          , Gg^Ve       , Gg          , Wwf         , Wwf         , Wwf         , Gg          , Gg          
Wo          ,Wo          , Wo          , Wo          , Wo          , Wo          , Ai          , Ds          , Dd^Vdt      , Ce          , Ce          , Dd^Vdt      , Ww          , Ww          , Ww          , Ww          , Ww          , Ww          , Ww          , Ww          , Ww          , Ww          , Ww          , Ww          , Ww          , Ww          , Ww          , Wwf         , Ww          , Ds          , Ww          , Gg          , Gg          , Gg          , Ai          , Ai          , Ai          , Gg          , Gg          , Gg          , Gg          , Gg          
Wo          ,Wo          , Ww          , Wo          , Wo          , Ai          , Ai          , Ai          , Ai          , Ds          , Ds          , Ds          , Wwf         , Ww          , Ds          , Ww          , Ww          , Ww          , Ww          , Ww          , Ww          , Ww          , Ww          , Ww          , Ww          , Ww          , Ww          , Ds          , Ds          , Ds          , Ds          , Ds          , Gg          , Gg          , Ai          , Ai          , Ai          , Ai          , Gg          , Gg          , Gg          , Gg          
Ww          ,Ww          , Ai          , Ww          , Ai          , Ai          , Ww          , Ww          , Ww          , Ww          , Ds          , Ds          , Wwf         , Ww          , Wwf         , Wwf         , Ww          , Ww          , Ds          , Ds          , Ds          , Ww          , Ww          , Ww          , Ww          , Ww          , Wwf         , Ds          , Gg          , Ds          , Ds          , Gg          , Ai          , Ai          , Gg          , Ai          , Gg          , Gg          , Gg          , Gg          , Gg          , Gg          
Ww          ,Ww          , Ww          , Ww          , Ww          , Ww          , Ww          , Ww          , Ww          , Ww          , Ds          , Ww          , Ds          , Ww          , Wwf         , Ww          , Ww          , Ds          , Ww          , Ds          , Ww          , Ds          , Ww          , Ww          , Ai          , Wwf         , Wwf         , Wwf         , Gg          , Gg          , Gg          , Ds          , Gg          , Gg          , Gg          , Gg          , Gg          , Gg          , Aa^Fpa      , Gg          , Gs^Fp       , Gs^Fp       
Ww          ,Ww          , Ww          , Ww          , Ww          , Ww          , Ds          , Ww          , Ww          , Ww          , Ww          , Ds          , Ds          , Wwf         , Wwf         , Wwf         , Wwf         , Ww          , Ww          , Wwf         , Wwf         , Ww          , Ww          , Ai          , Wwf         , Wwf         , Wwf         , Gg          , Wwf         , Gg^Ve       , Gg          , Gg          , Gg          , Gg          , Gg          , Gg          , Gg          , Gg          , Ha          , Ha          , Gg^Ve       , Gg       
Ww          ,Ww          , Ww          , Ww          , Ds          , Ds          , Ds          , Ww          , Ww          , Ww          , Wwf         , Ds          , Wwf         , Ds          , Ds          , Ds          , Ds          , Ds          , Ds          , Wwf         , Wwf         , Wwf         , Ai          , Ai          , Ai          , Ai          , Ds          , Ds          , Ds          , Gg          , Gg          , Gg          , Gg          , Gg          , Gg          , Gg          , Aa^Fpa      , Aa^Fpa      , Gg          , Ha          , Gs^Fp       , Gs^Fp       
Ww          ,Ww          , Ww          , Ww          , Ds          , Ds          , Ww          , Ww          , Ww          , Ds          , Wwf         , Wwf         , Ww          , Ds          , Ds          , Ds          , Gg          , Ds          , Gg          , Gg          , Gg          , Wwf         , Wwf         , Wwf         , Ai          , Ai          , Ai          , Ai          , Ds          , Gg          , Ha          , Gg          , Ha          , Ha          , Gg          , Aa^Fpa      , Aa^Fpa      , Aa^Fpa      , Aa^Fpa      , Ha          , Gs^Fp       , Gs^Fp       
Ww          ,Ww          , Ww          , Ds          , Ww          , Ww          , Ww          , Ww          , Wwf         , Ww          , Wwf         , Ww          , Ds          , Ds          , Gg          , Gg          , Ai          , Gg          , Gg          , Gg          , Gg          , Gg          , Gg          , Wwf         , Gg          , Ai          , Ds          , Ds          , Gg          , Gg          , Gs^Fp       , Ha          , Ha          , Ha          , Gg          , Gg          , Aa^Fpa      , Gs^Fp       , Aa^Fpa      , Gg          , Ha          , Ha          
Ww          ,Ww          , Ww          , Ww          , Ww          , Ww          , Ww          , Ww          , Wwf         , Wwf         , Gg          , Ds          , Gg          , Gg          , Ai          , Ai          , Gg          , Gg          , Gg          , Gg          , Gg          , Gg          , Gg          , Gg          , Gg          , Gg          , Gg          , Gg          , Gs^Fp       , Ha          , Gg          , Ha          , Gs^Fp       , Gs^Fp       , Gs^Fp       , Gs^Fp       , Aa^Fpa      , Aa^Fpa      , Aa^Fpa      , Aa^Fpa      , Ha          , Ha          
Ww          ,Ww          , Ww          , Ww          , Ww          , Ww          , Wwf         , Wwf         , Wwf         , Wwf         , Ww          , Ww          , Ai          , Ai          , Gg          , Gg          , Gg          , Gg          , Gg          , Gg          , Gg          , Gg          , Aa^Fpa      , Gg          , Gs^Fp       , Gs^Fp       , Gs^Fp       , Gs^Fp       , Aa^Fpa      , Gs^Fp       , Gg          , Gg          , Hh          , Hh          , Gg          , Gs^Fp       , Gs^Fp       , Gs^Fp       , Aa^Fpa      , Aa^Fpa      , Gs^Fp       , Gs^Fp       
Ds          ,Ds          , Wwf         , Wwf         , Ds          , Ww          , Ww          , Gg          , Gg          , Gg          , Gg          , Gg          , Gg          , Gg          , Gg          , Gg          , Gg          , Gg          , Gg          , Gg          , Gs^Fp       , Gs^Fp       , Aa^Fpa      , Gs^Fp       , Aa^Fpa      , Gs^Fp       , Aa^Fpa      , Aa^Fpa      , Gs^Fp       , Gg          , Hh          , Hh          , Gs^Fp       , Gg          , Gg          , Gg          , Gs^Fp       , Aa^Fpa      , Gs^Fp       , Gg          , Gs^Fp       , Gs^Fp       
Wwf         ,Wwf         , Gg          , Ds          , Ww          , Ww          , Ww          , Ww          , Ww          , Ww          , Ww          , Gg          , Gg          , Gg          , Gg          , Gg          , Gg          , Gg          , Gs^Fp       , Gs^Fp       , Aa^Fpa      , Aa^Fpa      , Gs^Fp       , Aa^Fpa      , Gs^Fp       , Gs^Fp       , Gs^Fp       , Gs^Fp       , Gg          , Gg          , Hh          , Gg          , Gs^Fp       , Gs^Fp       , Aa^Fpa      , Gs^Fp       , Gs^Fp       , Gs^Fp       , Gg          , Gg          , Gs^Fp       , Gs^Fp       
Gg          ,Gg          , Ds          , Ds          , Ww          , Ww          , Gg          , Ww          , Ww          , Gg          , Ww          , Gg          , Gg          , Gg          , Gg          , Gg          , Gs^Fp       , Gg          , Gs^Fp       , Aa^Fpa      , Gs^Fp       , Gs^Fp       , Gs^Fp       , Gs^Fp       , Gs^Fp       , Gs^Fp       , Gg          , Gg          , Gg          , Hh          , Gs^Fp       , Gs^Fp       , Aa^Fpa      , Aa^Fpa      , Gs^Fp       , Gs^Fp       , Gg          , Gg^Ve       , Gg          , Gg          , Gg          , Gg          
Gg          ,Gg          , Ds          , Ds          , Gg          , Gg          , Gg          , Gg          , Gg          , Ww          , Ww          , Ww          , Ww          , Gg          , Gg          , Gs^Fp       , Gs^Fp       , Gg          , Gg          , Gs^Fp       , Gs^Fp       , Gs^Fp       , Gs^Fp       , Gg          , Gs^Fp       , Gg          , Gg          , Gg^Ve       , Gg          , Hh          , Hh          , Hh          , Hh          , Gs^Fp       , Gg          , Gg          , Gg          , Gs^Fp       , Gg          , Gs^Fp       , Gg          , Gg          
Gg       ,Gg^Ve       , Gg          , Gg          , Gg          , Gg          , Ha          , Gg          , Gg          , Gg          , Ww          , Ww          , Gg          , Gg          , Gg          , Gs^Fp       , Gg          , Gg          , Gg          , Gg          , Gg          , Gs^Fp       , Gg          , Gg          , Gg          , Gg          , Gg          , Gg          , Hh          , Hh          , Aa^Fpa      , Hh          , Hh          , Gg          , Aa^Fpa      , Gg          , Gs^Fp       , Gs^Fp       , Gg          , Hh          , Gg          , Gg          
Gg          ,Gg          , Gg          , Gg          , Gg          , Ha          , Gg          , Ha          , Gg          , Gg          , Gg          , Ww          , Gg          , Gg          , Gg          , Gg          , Gg          , Gg          , Gg          , Gs^Fp       , Gs^Fp       , Gg          , Gs^Fp       , Gg          , Gs^Fp       , Gs^Fp       , Gg          , Hh          , Hh          , Hh          , Gs^Fp       , Gs^Fp       , Ce          , Hh          , Gs^Fp       , Ce          , Gg          , Gg          , Hh          , Hh          , Gs^Fp       , Gs^Fp       
Gg          ,Gg          , Gs^Fp       , Gg          , Gs^Fp       , Gs^Fp       , Gs^Fp       , Ha          , Gg          , Gg          , Ww          , Ww          , Ww          , Gg          , Gg          , Gg          , Gg          , Gg^Ve       , Gg          , Gg          , Gg          , Gg          , Gg          , Gs^Fp       , Gs^Fp       , Gs^Fp       , Gg          , Gs^Fp       , Gs^Fp       , Gg          , Gs^Fp       , Gg          , Ce          , 2 Ke        , Ce          , Ce          , Gs^Fp       , Gs^Fp       , Gs^Fp       , Hh          , Gs^Fp       , Gs^Fp       
Gs^Fp       ,Gs^Fp       , Gg^Ve       , Gg          , Aa^Fpa      , Gs^Fp       , Gs^Fp       , Gs^Fp       , Gg          , Gg          , Ww          , Gg^Ve       , Ww          , Gg          , Gg          , Gg          , Gg          , Gg          , Gs^Fp       , Gg          , Gs^Fp       , Gg          , Gs^Fp       , Gs^Fp       , Gs^Fp       , Gs^Fp       , Gs^Fp       , Gg          , Gg          , Gs^Fp       , Gs^Fp       , Gs^Fp       , Gg          , Gg          , Gg          , Gg          , Gs^Fp       , Gg^Ve       , Gs^Fp       , Hh          , Gs^Fp       , Gs^Fp       
Gg          ,Gg          , Gg          , Gs^Fp       , Aa^Fpa      , Aa^Fpa      , Gs^Fp       , Gs^Fp       , Gg          , Gg          , Ww          , Ww          , Gg          , Ww          , Gg          , Gg          , Gg          , Gs^Fp       , Gs^Fp       , Gg          , Gs^Fp       , Gs^Fp       , Gs^Fp       , Gs^Fp       , Gs^Fp       , Gs^Fp       , Gs^Fp       , Gg          , Gg          , Gg          , Gs^Fp       , Hh          , Gs^Fp       , Gs^Fp       , Gs^Fp       , Gs^Fp       , Gs^Fp       , Gs^Fp       , Aa^Fpa      , Hh          , Gs^Fp       , Gs^Fp       
Gg          ,Gg          , Gg          , Gs^Fp       , Aa^Fpa      , Aa^Fpa      , Gs^Fp       , Gs^Fp       , Gg          , Gg          , Ww          , Ww          , Gg          , Ww          , Gg          , Gg          , Gg          , Gs^Fp       , Gs^Fp       , Gg          , Gs^Fp       , Gs^Fp       , Gs^Fp       , Gs^Fp       , Gs^Fp       , Gs^Fp       , Gs^Fp       , Gg          , Gg          , Gg          , Gs^Fp       , Hh          , Gs^Fp       , Gs^Fp       , Gs^Fp       , Gs^Fp       , Gs^Fp       , Gs^Fp       , Aa^Fpa      , Hh          , Gs^Fp       , Gs^Fp       
